date,county,state,vehicle_primary_use,battery_electric_vehicles_bevs_,plug_in_hybrid_electric_vehicles_phevs_,electric_vehicle_ev_total,non_electric_vehicles,total_vehicles,percent_electric_vehicles,index
2020-06-30T00:00:00.000,Juneau,AK,Passenger,0,2,2,28,30,6.666666667,1
2020-06-30T00:00:00.000,Lee,FL,Passenger,1,0,1,45,46,2.173913043,2
2020-06-30T00:00:00.000,Maui,HI,Passenger,1,0,1,31,32,3.125,3
2020-06-30T00:00:00.000,Middlesex,MA,Passenger,1,1,2,99,101,1.98019802,4
2020-05-31T00:00:00.000,Jones,GA,Passenger,1,0,1,1,2,50,5
2020-05-31T00:00:00.000,Kern,CA,Passenger,0,1,1,226,227,0.440528634,6
2020-05-31T00:00:00.000,Kitsap,WA,Passenger,1313,678,1991,179673,181664,1.095979391,7
2020-05-31T00:00:00.000,Klickitat,WA,Truck,0,0,0,8121,8121,0,8
2020-05-31T00:00:00.000,Manassas,VA,Passenger,0,1,1,4,5,20,9
2020-04-30T00:00:00.000,Sedgwick,KS,Passenger,1,1,2,90,92,2.173913043,10
2020-04-30T00:00:00.000,Skagit,WA,Passenger,397,215,612,91487,92099,0.664502329,11
2020-04-30T00:00:00.000,St. Mary's,MD,Passenger,1,0,1,216,217,0.460829493,12
2020-04-30T00:00:00.000,Thurston,WA,Passenger,1142,729,1871,197530,199401,0.938310239,13
2020-04-30T00:00:00.000,Washington,OR,Passenger,1,0,1,435,436,0.229357798,14
2020-03-31T00:00:00.000,Whatcom,WA,Truck,3,0,3,43031,43034,0.006971232,15
2020-03-31T00:00:00.000,Yakima,WA,Truck,0,0,0,59604,59604,0,16
2020-04-30T00:00:00.000,Asotin,WA,Passenger,16,12,28,12446,12474,0.224466891,17
2020-04-30T00:00:00.000,Boone,MO,Passenger,0,1,1,13,14,7.142857143,18
2020-04-30T00:00:00.000,Broward,FL,Passenger,3,1,4,112,116,3.448275862,19
2020-04-30T00:00:00.000,Camden,NJ,Passenger,0,2,2,21,23,8.695652174,20
2020-07-31T00:00:00.000,Middlesex,MA,Passenger,1,1,2,96,98,2.040816327,21
2020-07-31T00:00:00.000,Monroe,IL,Passenger,1,0,1,4,5,20,22
2020-07-31T00:00:00.000,Montgomery,OH,Passenger,0,1,1,47,48,2.083333333,23
2020-07-31T00:00:00.000,Moore,NC,Passenger,0,2,2,158,160,1.25,24
2020-07-31T00:00:00.000,Okaloosa,FL,Passenger,0,1,1,138,139,0.71942446,25
2020-07-31T00:00:00.000,Pima,AZ,Passenger,3,1,4,338,342,1.169590643,26
2020-07-31T00:00:00.000,Pinellas,FL,Passenger,1,1,2,106,108,1.851851852,27
2020-07-31T00:00:00.000,Polk,FL,Passenger,1,0,1,65,66,1.515151515,28
2020-03-31T00:00:00.000,Grant,WA,Passenger,58,71,129,65497,65626,0.196568433,29
2020-03-31T00:00:00.000,Grant,WA,Truck,0,0,0,27058,27058,0,30
2020-03-31T00:00:00.000,Grays Harbor,WA,Truck,0,0,0,20785,20785,0,31
2020-03-31T00:00:00.000,Juneau,AK,Passenger,0,2,2,31,33,6.060606061,32
2020-03-31T00:00:00.000,Lee,FL,Passenger,1,0,1,47,48,2.083333333,33
2020-04-30T00:00:00.000,Howard,MD,Passenger,0,1,1,71,72,1.388888889,34
2020-04-30T00:00:00.000,Kern,CA,Passenger,0,1,1,226,227,0.440528634,35
2020-04-30T00:00:00.000,Kitsap,WA,Passenger,1313,676,1989,180585,182574,1.089421276,36
2020-04-30T00:00:00.000,Kittitas,WA,Passenger,101,49,150,29860,30010,0.499833389,37
2020-04-30T00:00:00.000,Kittitas,WA,Truck,0,0,0,14590,14590,0,38
2020-04-30T00:00:00.000,Klamath,OR,Passenger,1,0,1,31,32,3.125,39
2020-04-30T00:00:00.000,Larimer,CO,Passenger,1,0,1,52,53,1.886792453,40
2020-04-30T00:00:00.000,Lincoln,WA,Passenger,4,12,16,7682,7698,0.207846194,41
2020-04-30T00:00:00.000,Loudoun,VA,Passenger,1,0,1,89,90,1.111111111,42
2020-05-31T00:00:00.000,Bexar,TX,Passenger,2,5,7,601,608,1.151315789,43
2020-05-31T00:00:00.000,Chesapeake,VA,Passenger,0,2,2,424,426,0.469483568,44
2020-06-30T00:00:00.000,Chelan,WA,Truck,0,0,0,22521,22521,0,45
2020-06-30T00:00:00.000,Cowlitz,WA,Passenger,138,115,253,72330,72583,0.348566469,46
2020-06-30T00:00:00.000,El Paso,TX,Passenger,3,0,3,420,423,0.709219858,47
2020-06-30T00:00:00.000,Flathead,MT,Passenger,1,0,1,58,59,1.694915254,48
2020-06-30T00:00:00.000,Fort Bend,TX,Passenger,1,0,1,47,48,2.083333333,49
2020-06-30T00:00:00.000,Garfield,WA,Truck,0,0,0,974,974,0,50
2020-04-30T00:00:00.000,Douglas,WA,Truck,0,0,0,12269,12269,0,51
2020-04-30T00:00:00.000,DuPage,IL,Passenger,3,0,3,56,59,5.084745763,52
2020-04-30T00:00:00.000,El Paso,CO,Passenger,2,0,2,720,722,0.27700831,53
2020-03-31T00:00:00.000,Maui,HI,Passenger,1,0,1,34,35,2.857142857,54
2020-03-31T00:00:00.000,Middlesex,MA,Passenger,1,1,2,107,109,1.834862385,55
2020-03-31T00:00:00.000,New Haven,CT,Passenger,0,2,2,41,43,4.651162791,56
2020-05-31T00:00:00.000,Montgomery,TX,Passenger,1,0,1,52,53,1.886792453,57
2020-05-31T00:00:00.000,New London,CT,Passenger,1,2,3,254,257,1.167315175,58
2020-05-31T00:00:00.000,Orange,CA,Passenger,7,2,9,493,502,1.792828685,59
2020-05-31T00:00:00.000,Pacific,WA,Truck,0,0,0,7626,7626,0,60
2020-05-31T00:00:00.000,Powhatan,VA,Passenger,1,0,1,0,1,100,61
2020-05-31T00:00:00.000,Richmond,GA,Passenger,0,1,1,92,93,1.075268817,62
2020-05-31T00:00:00.000,Riverside,CA,Passenger,3,1,4,626,630,0.634920635,63
2020-05-31T00:00:00.000,Saginaw,MI,Passenger,1,0,1,10,11,9.090909091,64
2020-05-31T00:00:00.000,San Juan,WA,Truck,0,0,0,5861,5861,0,65
2020-05-31T00:00:00.000,Shasta,CA,Passenger,1,0,1,36,37,2.702702703,66
2020-07-31T00:00:00.000,San Mateo,CA,Passenger,0,1,1,106,107,0.934579439,67
2020-07-31T00:00:00.000,Sarasota,FL,Passenger,2,0,2,25,27,7.407407407,68
2020-07-31T00:00:00.000,Stevens,WA,Passenger,37,35,72,30629,30701,0.234520048,69
2020-07-31T00:00:00.000,Stevens,WA,Truck,0,0,0,18672,18672,0,70
2020-07-31T00:00:00.000,Twin Falls,ID,Passenger,0,1,1,20,21,4.761904762,71
2020-07-31T00:00:00.000,Vigo,IN,Passenger,1,0,1,5,6,16.66666667,72
2020-07-31T00:00:00.000,Wahkiakum,WA,Truck,0,0,0,1742,1742,0,73
2020-07-31T00:00:00.000,Washoe,NV,Passenger,1,0,1,97,98,1.020408163,74
2020-06-30T00:00:00.000,New Haven,CT,Passenger,0,2,2,38,40,5,75
2020-06-30T00:00:00.000,Pend Oreille,WA,Passenger,7,6,13,9243,9256,0.140449438,76
2020-06-30T00:00:00.000,Pend Oreille,WA,Truck,0,0,0,5763,5763,0,77
2020-06-30T00:00:00.000,Placer,CA,Passenger,1,0,1,85,86,1.162790698,78
2020-06-30T00:00:00.000,RÃ­o Grande,PR,Passenger,1,0,1,1,2,50,79
2020-06-30T00:00:00.000,Ramsey,MN,Passenger,1,0,1,41,42,2.380952381,80
2020-06-30T00:00:00.000,San Diego,CA,Passenger,15,6,21,2792,2813,0.74653395,81
2020-05-31T00:00:00.000,Stafford,VA,Passenger,1,1,2,89,91,2.197802198,82
2020-05-31T00:00:00.000,Suffolk,MA,Passenger,0,2,2,35,37,5.405405405,83
2020-05-31T00:00:00.000,Valencia,NM,Passenger,1,0,1,5,6,16.66666667,84
2020-06-30T00:00:00.000,Ada,ID,Passenger,0,1,1,264,265,0.377358491,85
2020-06-30T00:00:00.000,Arlington,VA,Passenger,0,2,2,147,149,1.342281879,86
2020-06-30T00:00:00.000,Bartow,GA,Passenger,0,1,1,2,3,33.33333333,87
2020-06-30T00:00:00.000,Goochland,VA,Passenger,2,1,3,245,248,1.209677419,88
2020-06-30T00:00:00.000,Greene,MO,Passenger,0,1,1,31,32,3.125,89
2020-06-30T00:00:00.000,Hamilton,IN,Passenger,1,0,1,40,41,2.43902439,90
2020-06-30T00:00:00.000,Harris,TX,Passenger,1,0,1,225,226,0.442477876,91
2020-06-30T00:00:00.000,Honolulu,HI,Passenger,4,1,5,443,448,1.116071429,92
2020-06-30T00:00:00.000,Island,WA,Passenger,419,268,687,62816,63503,1.081838653,93
2020-06-30T00:00:00.000,Jefferson,WA,Truck,0,0,0,9535,9535,0,94
2020-08-31T00:00:00.000,Ada,ID,Passenger,0,1,1,251,252,0.396825397,95
2020-08-31T00:00:00.000,Bell,TX,Passenger,0,1,1,415,416,0.240384615,96
2020-08-31T00:00:00.000,Boone,MO,Passenger,0,1,1,11,12,8.333333333,97
2020-08-31T00:00:00.000,Calvert,MD,Passenger,0,2,2,86,88,2.272727273,98
2020-08-31T00:00:00.000,Camden,NJ,Passenger,0,1,1,22,23,4.347826087,99
2020-08-31T00:00:00.000,Clackamas,OR,Passenger,2,0,2,182,184,1.086956522,100
2020-05-31T00:00:00.000,DeKalb,GA,Passenger,1,0,1,77,78,1.282051282,101
2020-05-31T00:00:00.000,Douglas,WA,Passenger,69,40,109,27970,28079,0.388190463,102
2020-05-31T00:00:00.000,Frederick,MD,Passenger,1,1,2,77,79,2.53164557,103
2020-05-31T00:00:00.000,Grant,WA,Passenger,59,70,129,65212,65341,0.197425812,104
2020-05-31T00:00:00.000,Grays Harbor,WA,Truck,0,0,0,20769,20769,0,105
2020-05-31T00:00:00.000,Houston,GA,Passenger,1,0,1,53,54,1.851851852,106
2020-04-30T00:00:00.000,Juneau,AK,Passenger,0,2,2,31,33,6.060606061,107
2020-04-30T00:00:00.000,Kent,MI,Passenger,0,1,1,23,24,4.166666667,108
2020-04-30T00:00:00.000,Kitsap,WA,Truck,1,0,1,53924,53925,0.001854427,109
2020-04-30T00:00:00.000,Lewis,WA,Passenger,99,106,205,58657,58862,0.34827223,110
2020-04-30T00:00:00.000,Montgomery,PA,Passenger,1,0,1,31,32,3.125,111
2020-04-30T00:00:00.000,New London,CT,Passenger,1,2,3,253,256,1.171875,112
2020-04-30T00:00:00.000,Orange,CA,Passenger,7,2,9,496,505,1.782178218,113
2020-04-30T00:00:00.000,Riverside,CA,Passenger,3,1,4,630,634,0.630914826,114
2020-04-30T00:00:00.000,Sacramento,CA,Passenger,1,0,1,264,265,0.377358491,115
2020-04-30T00:00:00.000,San Juan,WA,Passenger,295,88,383,14157,14540,2.634112792,116
2020-04-30T00:00:00.000,Santa Clara,CA,Passenger,6,2,8,315,323,2.476780186,117
2020-03-31T00:00:00.000,Pend Oreille,WA,Truck,0,0,0,5759,5759,0,118
2020-03-31T00:00:00.000,Placer,CA,Passenger,1,0,1,89,90,1.111111111,119
2020-03-31T00:00:00.000,RÃ­o Grande,PR,Passenger,1,0,1,1,2,50,120
2020-03-31T00:00:00.000,Ramsey,MN,Passenger,1,0,1,42,43,2.325581395,121
2020-03-31T00:00:00.000,San Diego,CA,Passenger,13,6,19,2814,2833,0.670667137,122
2020-03-31T00:00:00.000,Skamania,WA,Passenger,29,17,46,8720,8766,0.524754734,123
2020-03-31T00:00:00.000,St. Clair,IL,Passenger,1,0,1,144,145,0.689655172,124
2020-06-30T00:00:00.000,Calvert,MD,Passenger,0,2,2,89,91,2.197802198,125
2020-06-30T00:00:00.000,Charleston,SC,Passenger,1,0,1,103,104,0.961538462,126
2020-06-30T00:00:00.000,Clark,WA,Passenger,2014,1056,3070,317718,320788,0.957018342,127
2020-06-30T00:00:00.000,DeKalb,GA,Passenger,1,0,1,78,79,1.265822785,128
2020-06-30T00:00:00.000,District of Columbia,DC,Passenger,2,1,3,195,198,1.515151515,129
2020-04-30T00:00:00.000,New Haven,CT,Passenger,0,2,2,41,43,4.651162791,130
2020-04-30T00:00:00.000,Norfolk,VA,Passenger,2,2,4,354,358,1.117318436,131
2020-04-30T00:00:00.000,Nueces,TX,Passenger,1,0,1,79,80,1.25,132
2020-04-30T00:00:00.000,Owyhee,ID,Passenger,1,0,1,3,4,25,133
2020-04-30T00:00:00.000,Palm Beach,FL,Passenger,0,1,1,74,75,1.333333333,134
2020-04-30T00:00:00.000,Rockingham,NH,Passenger,1,0,1,28,29,3.448275862,135
2020-04-30T00:00:00.000,Rogers,OK,Passenger,1,0,1,6,7,14.28571429,136
2020-04-30T00:00:00.000,Santa Cruz,CA,Passenger,1,0,1,38,39,2.564102564,137
2020-08-31T00:00:00.000,Contra Costa,CA,Passenger,4,2,6,320,326,1.840490798,138
2020-08-31T00:00:00.000,DeKalb,IN,Passenger,1,0,1,1,2,50,139
2020-08-31T00:00:00.000,Douglas,CO,Passenger,0,1,1,77,78,1.282051282,140
2020-08-31T00:00:00.000,Ferry,WA,Truck,0,0,0,3580,3580,0,141
2020-08-31T00:00:00.000,Franklin,WA,Passenger,66,77,143,60798,60941,0.234653189,142
2020-08-31T00:00:00.000,Hennepin,MN,Passenger,3,0,3,86,89,3.370786517,143
2020-05-31T00:00:00.000,King,WA,Passenger,24025,7684,31709,1375179,1406888,2.25383968,144
2020-05-31T00:00:00.000,Kittitas,WA,Truck,0,0,0,14551,14551,0,145
2020-05-31T00:00:00.000,Middlesex,MA,Passenger,1,1,2,101,103,1.941747573,146
2020-05-31T00:00:00.000,Monroe,IL,Passenger,1,0,1,4,5,20,147
2020-04-30T00:00:00.000,Solano,CA,Passenger,1,0,1,218,219,0.456621005,148
2020-04-30T00:00:00.000,Stafford,VA,Passenger,1,1,2,87,89,2.247191011,149
2020-04-30T00:00:00.000,Suffolk,VA,Passenger,1,0,1,121,122,0.819672131,150
2020-04-30T00:00:00.000,Sumter,FL,Passenger,0,1,1,9,10,10,151
2020-04-30T00:00:00.000,Thurston,WA,Truck,0,0,0,55508,55508,0,152
2020-04-30T00:00:00.000,Travis,TX,Passenger,2,1,3,179,182,1.648351648,153
2020-04-30T00:00:00.000,Ventura,CA,Passenger,0,3,3,295,298,1.006711409,154
2020-04-30T00:00:00.000,Whitman,WA,Passenger,44,48,92,22315,22407,0.410585978,155
2020-06-30T00:00:00.000,Mason,WA,Passenger,159,135,294,47286,47580,0.617906683,156
2020-06-30T00:00:00.000,Multnomah,OR,Passenger,4,7,11,697,708,1.553672316,157
2020-06-30T00:00:00.000,Nassau,NY,Passenger,4,0,4,29,33,12.12121212,158
2020-06-30T00:00:00.000,Newport,RI,Passenger,1,0,1,83,84,1.19047619,159
2020-06-30T00:00:00.000,Okanogan,WA,Passenger,36,33,69,25848,25917,0.266234518,160
2020-06-30T00:00:00.000,Osceola,FL,Passenger,1,0,1,36,37,2.702702703,161
2020-06-30T00:00:00.000,Penobscot,ME,Passenger,0,1,1,13,14,7.142857143,162
2020-06-30T00:00:00.000,Pierce,WA,Passenger,2382,1693,4075,549788,553863,0.73574151,163
2020-06-30T00:00:00.000,Pinellas,FL,Passenger,1,1,2,107,109,1.834862385,164
2020-03-31T00:00:00.000,Walla Walla,WA,Passenger,68,63,131,36246,36377,0.360117657,165
2020-03-31T00:00:00.000,Yakima,WA,Passenger,124,116,240,165859,166099,0.14449214,166
2020-04-30T00:00:00.000,Benton,WA,Passenger,348,321,669,134580,135249,0.494643214,167
2020-04-30T00:00:00.000,Brevard,FL,Passenger,0,1,1,85,86,1.162790698,168
2020-04-30T00:00:00.000,Cascade,MT,Passenger,0,1,1,58,59,1.694915254,169
2020-08-31T00:00:00.000,Juneau,AK,Passenger,0,1,1,27,28,3.571428571,170
2020-08-31T00:00:00.000,Kittitas,WA,Passenger,110,47,157,29766,29923,0.524680012,171
2020-08-31T00:00:00.000,Klamath,OR,Passenger,1,0,1,29,30,3.333333333,172
2020-08-31T00:00:00.000,Lincoln,WA,Truck,0,0,0,4652,4652,0,173
2020-08-31T00:00:00.000,Maui,HI,Passenger,1,0,1,30,31,3.225806452,174
2020-06-30T00:00:00.000,Skamania,WA,Passenger,31,17,48,8483,8531,0.562653851,175
2020-06-30T00:00:00.000,Walla Walla,WA,Passenger,73,62,135,35839,35974,0.375271029,176
2020-06-30T00:00:00.000,Whatcom,WA,Passenger,1065,500,1565,149278,150843,1.037502569,177
2020-06-30T00:00:00.000,Yakima,WA,Passenger,132,119,251,165374,165625,0.15154717,178
2020-07-31T00:00:00.000,Adams,WA,Passenger,9,7,16,12865,12881,0.124213959,179
2020-07-31T00:00:00.000,Adams,WA,Truck,0,0,0,5282,5282,0,180
2020-07-31T00:00:00.000,Albemarle,VA,Passenger,1,0,1,20,21,4.761904762,181
2020-07-31T00:00:00.000,Anne Arundel,MD,Passenger,0,1,1,406,407,0.245700246,182
2020-07-31T00:00:00.000,Arapahoe,CO,Passenger,1,0,1,127,128,0.78125,183
2020-07-31T00:00:00.000,Asotin,WA,Truck,0,0,0,6653,6653,0,184
2020-06-30T00:00:00.000,Ferry,WA,Passenger,5,3,8,4330,4338,0.184416782,185
2020-06-30T00:00:00.000,Fresno,CA,Passenger,1,0,1,183,184,0.543478261,186
2020-06-30T00:00:00.000,Fulton,GA,Passenger,1,2,3,97,100,3,187
2020-06-30T00:00:00.000,Grant,WA,Truck,0,0,0,27089,27089,0,188
2020-06-30T00:00:00.000,Houston,GA,Passenger,1,0,1,54,55,1.818181818,189
2020-06-30T00:00:00.000,Jefferson,NY,Passenger,0,1,1,210,211,0.473933649,190
2020-06-30T00:00:00.000,Kent,MI,Passenger,0,1,1,23,24,4.166666667,191
2020-06-30T00:00:00.000,King,WA,Passenger,24117,7708,31825,1371259,1403084,2.268217726,192
2020-04-30T00:00:00.000,Snohomish,WA,Passenger,4401,1753,6154,535230,541384,1.136716268,193
2020-04-30T00:00:00.000,Spokane,WA,Passenger,711,472,1183,316352,317535,0.372557356,194
2020-04-30T00:00:00.000,St. Clair,IL,Passenger,1,0,1,143,144,0.694444444,195
2020-04-30T00:00:00.000,St. Louis,MO,Passenger,1,0,1,98,99,1.01010101,196
2020-04-30T00:00:00.000,Yakima,WA,Truck,0,0,0,59524,59524,0,197
2020-07-31T00:00:00.000,Clackamas,OR,Passenger,2,0,2,189,191,1.047120419,198
2020-07-31T00:00:00.000,DeKalb,IN,Passenger,1,0,1,1,2,50,199
2020-07-31T00:00:00.000,Erie,NY,Passenger,1,0,1,43,44,2.272727273,200
2020-08-31T00:00:00.000,Montgomery,AL,Passenger,0,1,1,38,39,2.564102564,201
2020-08-31T00:00:00.000,New Haven,CT,Passenger,0,2,2,35,37,5.405405405,202
2020-05-31T00:00:00.000,Moore,NC,Passenger,0,1,1,163,164,0.609756098,203
2020-05-31T00:00:00.000,Okanogan,WA,Truck,0,0,0,16388,16388,0,204
2020-05-31T00:00:00.000,Pend Oreille,WA,Truck,0,0,0,5744,5744,0,205
2020-05-31T00:00:00.000,Pima,AZ,Passenger,3,1,4,346,350,1.142857143,206
2020-05-31T00:00:00.000,Placer,CA,Passenger,1,0,1,84,85,1.176470588,207
2020-05-31T00:00:00.000,Ramsey,MN,Passenger,1,0,1,41,42,2.380952381,208
2020-05-31T00:00:00.000,San Diego,CA,Passenger,15,6,21,2773,2794,0.751610594,209
2020-05-31T00:00:00.000,Benton,WA,Truck,0,0,0,42473,42473,0,210
2020-05-31T00:00:00.000,Broward,FL,Passenger,2,1,3,110,113,2.654867257,211
2020-05-31T00:00:00.000,Cascade,MT,Passenger,0,1,1,58,59,1.694915254,212
2020-05-31T00:00:00.000,Chelan,WA,Truck,0,0,0,22435,22435,0,213
2020-05-31T00:00:00.000,Cowlitz,WA,Passenger,136,115,251,72373,72624,0.345615774,214
2020-05-31T00:00:00.000,Alameda,CA,Passenger,2,1,3,269,272,1.102941176,215
2020-05-31T00:00:00.000,Brevard,FL,Passenger,0,1,1,83,84,1.19047619,216
2020-05-31T00:00:00.000,Carroll,NH,Passenger,0,1,1,4,5,20,217
2020-05-31T00:00:00.000,Charles,MD,Passenger,1,1,2,73,75,2.666666667,218
2020-05-31T00:00:00.000,Clay,FL,Passenger,0,1,1,80,81,1.234567901,219
2020-05-31T00:00:00.000,Denton,TX,Passenger,1,0,1,85,86,1.162790698,220
2020-05-31T00:00:00.000,Douglas,NE,Passenger,0,1,1,56,57,1.754385965,221
2020-06-30T00:00:00.000,Queens,NY,Passenger,1,0,1,50,51,1.960784314,222
2020-06-30T00:00:00.000,San Francisco,CA,Passenger,1,1,2,89,91,2.197802198,223
2020-06-30T00:00:00.000,Skagit,WA,Passenger,407,221,628,91162,91790,0.684170389,224
2020-06-30T00:00:00.000,Skamania,WA,Truck,0,0,0,4011,4011,0,225
2020-06-30T00:00:00.000,St. Mary's,MD,Passenger,1,0,1,216,217,0.460829493,226
2020-06-30T00:00:00.000,Twin Falls,ID,Passenger,0,1,1,22,23,4.347826087,227
2020-06-30T00:00:00.000,Vigo,IN,Passenger,1,0,1,5,6,16.66666667,228
2020-06-30T00:00:00.000,Wahkiakum,WA,Truck,0,0,0,1737,1737,0,229
2020-06-30T00:00:00.000,Walla Walla,WA,Truck,0,0,0,13744,13744,0,230
2020-06-30T00:00:00.000,Larimer,CO,Passenger,1,0,1,51,52,1.923076923,231
2020-06-30T00:00:00.000,Mason,WA,Truck,0,0,0,20606,20606,0,232
2020-06-30T00:00:00.000,Monroe,IL,Passenger,1,0,1,4,5,20,233
2020-06-30T00:00:00.000,Monterey,CA,Passenger,0,1,1,164,165,0.606060606,234
2020-06-30T00:00:00.000,Moore,NC,Passenger,0,2,2,163,165,1.212121212,235
2020-06-30T00:00:00.000,Nassau,FL,Passenger,1,0,1,34,35,2.857142857,236
2020-06-30T00:00:00.000,Norfolk,VA,Passenger,2,2,4,351,355,1.126760563,237
2020-06-30T00:00:00.000,Oldham,KY,Passenger,0,1,1,4,5,20,238
2020-04-30T00:00:00.000,Chelan,WA,Truck,0,0,0,22460,22460,0,239
2020-04-30T00:00:00.000,Columbia,WA,Passenger,3,3,6,2407,2413,0.248653129,240
2020-04-30T00:00:00.000,Columbia,WA,Truck,0,0,0,1525,1525,0,241
2020-04-30T00:00:00.000,Cowlitz,WA,Truck,0,0,0,28769,28769,0,242
2020-04-30T00:00:00.000,Dakota,MN,Passenger,0,1,1,30,31,3.225806452,243
2020-04-30T00:00:00.000,Denver,CO,Passenger,1,0,1,120,121,0.826446281,244
2020-04-30T00:00:00.000,El Paso,TX,Passenger,3,0,3,435,438,0.684931507,245
2020-04-30T00:00:00.000,Fairbanks North Star,AK,Passenger,0,1,1,102,103,0.970873786,246
2020-04-30T00:00:00.000,Gwinnett,GA,Passenger,1,0,1,76,77,1.298701299,247
2020-08-31T00:00:00.000,San Juan,WA,Passenger,320,100,420,13930,14350,2.926829268,248
2020-08-31T00:00:00.000,Santa Clara,CA,Passenger,7,2,9,273,282,3.191489362,249
2020-08-31T00:00:00.000,Sedgwick,KS,Passenger,1,1,2,86,88,2.272727273,250
2020-08-31T00:00:00.000,Shelby,TN,Passenger,0,1,1,84,85,1.176470588,251
2020-08-31T00:00:00.000,St. Clair,IL,Passenger,1,0,1,144,145,0.689655172,252
2020-08-31T00:00:00.000,Thurston,WA,Passenger,1196,752,1948,197155,199103,0.97838807,253
2020-06-30T00:00:00.000,Washington,OR,Passenger,1,0,1,424,425,0.235294118,254
2020-06-30T00:00:00.000,Washoe,NV,Passenger,1,0,1,100,101,0.99009901,255
2020-07-31T00:00:00.000,,,Passenger,5,1,6,351,357,1.680672269,256
2020-07-31T00:00:00.000,Bell,TX,Passenger,0,1,1,419,420,0.238095238,257
2020-05-31T00:00:00.000,Jefferson,WA,Passenger,233,141,374,24827,25201,1.484068093,258
2020-05-31T00:00:00.000,King,WA,Truck,5,1,6,181433,181439,0.003306897,259
2020-05-31T00:00:00.000,Suffolk,VA,Passenger,1,0,1,117,118,0.847457627,260
2020-05-31T00:00:00.000,Ventura,CA,Passenger,1,2,3,292,295,1.016949153,261
2020-05-31T00:00:00.000,Virginia Beach,VA,Passenger,1,0,1,668,669,0.149476831,262
2020-05-31T00:00:00.000,Yakima,WA,Passenger,131,117,248,165041,165289,0.150040233,263
2020-06-30T00:00:00.000,Adams,WA,Passenger,9,7,16,12785,12801,0.124990235,264
2020-06-30T00:00:00.000,Arapahoe,CO,Passenger,1,0,1,128,129,0.775193798,265
2020-06-30T00:00:00.000,Pima,AZ,Passenger,3,1,4,343,347,1.152737752,266
2020-06-30T00:00:00.000,Putnam,TN,Passenger,0,1,1,3,4,25,267
2020-06-30T00:00:00.000,Sacramento,CA,Passenger,1,0,1,261,262,0.381679389,268
2020-06-30T00:00:00.000,Santa Cruz,CA,Passenger,1,0,1,33,34,2.941176471,269
2020-06-30T00:00:00.000,Sarasota,FL,Passenger,2,0,2,26,28,7.142857143,270
2020-06-30T00:00:00.000,Shelby,TN,Passenger,0,1,1,87,88,1.136363636,271
2020-06-30T00:00:00.000,Spartanburg,SC,Passenger,0,1,1,41,42,2.380952381,272
2020-06-30T00:00:00.000,St. Clair,IL,Passenger,1,0,1,141,142,0.704225352,273
2020-05-31T00:00:00.000,Dakota,MN,Passenger,0,1,1,30,31,3.225806452,274
2020-05-31T00:00:00.000,Flathead,MT,Passenger,1,0,1,61,62,1.612903226,275
2020-05-31T00:00:00.000,Fulton,GA,Passenger,1,2,3,100,103,2.912621359,276
2020-05-31T00:00:00.000,Goochland,VA,Passenger,2,1,3,247,250,1.2,277
2020-05-31T00:00:00.000,Hamilton,IN,Passenger,1,0,1,39,40,2.5,278
2020-05-31T00:00:00.000,Harris,TX,Passenger,1,0,1,228,229,0.436681223,279
2020-05-31T00:00:00.000,Island,WA,Passenger,408,270,678,62809,63487,1.067935168,280
2020-05-31T00:00:00.000,Island,WA,Truck,1,0,1,21140,21141,0.004730145,281
2020-05-31T00:00:00.000,Jefferson,NY,Passenger,0,1,1,210,211,0.473933649,282
2020-05-31T00:00:00.000,Kent,MI,Passenger,0,1,1,23,24,4.166666667,283
2020-07-31T00:00:00.000,Franklin,WA,Passenger,65,79,144,60783,60927,0.236348417,284
2020-07-31T00:00:00.000,Franklin,WA,Truck,0,0,0,20097,20097,0,285
2020-07-31T00:00:00.000,Garfield,WA,Passenger,0,1,1,1353,1354,0.073855244,286
2020-07-31T00:00:00.000,Honolulu,HI,Passenger,4,1,5,441,446,1.121076233,287
2020-07-31T00:00:00.000,Howard,MD,Passenger,0,1,1,69,70,1.428571429,288
2020-07-31T00:00:00.000,Jefferson,CO,Passenger,0,1,1,60,61,1.639344262,289
2020-07-31T00:00:00.000,Kern,CA,Passenger,0,1,1,223,224,0.446428571,290
2020-07-31T00:00:00.000,Kitsap,WA,Passenger,1378,696,2074,179912,181986,1.139648105,291
2020-07-31T00:00:00.000,Klamath,OR,Passenger,1,0,1,30,31,3.225806452,292
2020-04-30T00:00:00.000,Island,WA,Truck,1,0,1,21150,21151,0.004727909,293
2020-04-30T00:00:00.000,Klickitat,WA,Truck,0,0,0,8193,8193,0,294
2020-04-30T00:00:00.000,Kootenai,ID,Passenger,1,0,1,215,216,0.462962963,295
2020-04-30T00:00:00.000,Lake,FL,Passenger,1,0,1,20,21,4.761904762,296
2020-04-30T00:00:00.000,Montgomery,OH,Passenger,0,1,1,45,46,2.173913043,297
2020-08-31T00:00:00.000,Yakima,WA,Truck,0,0,0,60428,60428,0,298
2020-09-30T00:00:00.000,,,Passenger,5,1,6,341,347,1.729106628,299
2020-09-30T00:00:00.000,Boone,MO,Passenger,0,1,1,11,12,8.333333333,300
2020-09-30T00:00:00.000,Camden,NJ,Passenger,0,1,1,23,24,4.166666667,301
2020-09-30T00:00:00.000,Clark,WA,Truck,0,0,0,82863,82863,0,302
2020-07-31T00:00:00.000,Clallam,WA,Truck,1,0,1,21699,21700,0.004608295,303
2020-07-31T00:00:00.000,Contra Costa,CA,Passenger,4,2,6,323,329,1.823708207,304
2020-07-31T00:00:00.000,Deschutes,OR,Passenger,2,0,2,127,129,1.550387597,305
2020-07-31T00:00:00.000,Douglas,WA,Passenger,75,41,116,28057,28173,0.411741739,306
2020-07-31T00:00:00.000,Ferry,WA,Truck,0,0,0,3566,3566,0,307
2020-07-31T00:00:00.000,Frederick,MD,Passenger,1,1,2,76,78,2.564102564,308
2020-06-30T00:00:00.000,Travis,TX,Passenger,2,1,3,173,176,1.704545455,309
2020-06-30T00:00:00.000,Virginia Beach,VA,Passenger,1,0,1,664,665,0.15037594,310
2020-06-30T00:00:00.000,Whitman,WA,Passenger,44,48,92,22143,22235,0.413762087,311
2020-06-30T00:00:00.000,Yakima,WA,Truck,0,0,0,59903,59903,0,312
2020-07-31T00:00:00.000,Alameda,CA,Passenger,2,0,2,262,264,0.757575758,313
2020-07-31T00:00:00.000,Arlington,VA,Passenger,0,2,2,146,148,1.351351351,314
2020-07-31T00:00:00.000,Boone,MO,Passenger,0,1,1,11,12,8.333333333,315
2020-07-31T00:00:00.000,Boulder,CO,Passenger,0,1,1,43,44,2.272727273,316
2020-05-31T00:00:00.000,Lee,FL,Passenger,1,0,1,45,46,2.173913043,317
2020-05-31T00:00:00.000,Lincoln,WA,Passenger,4,12,16,7647,7663,0.208795511,318
2020-05-31T00:00:00.000,Loudoun,VA,Passenger,1,0,1,88,89,1.123595506,319
2020-05-31T00:00:00.000,Montgomery,PA,Passenger,1,0,1,30,31,3.225806452,320
2020-05-31T00:00:00.000,Pacific,WA,Passenger,31,33,64,15706,15770,0.405833862,321
2020-05-31T00:00:00.000,Pend Oreille,WA,Passenger,7,6,13,9217,9230,0.14084507,322
2020-07-31T00:00:00.000,Lincoln,WA,Truck,0,0,0,4661,4661,0,323
2020-07-31T00:00:00.000,Loudoun,VA,Passenger,1,0,1,83,84,1.19047619,324
2020-07-31T00:00:00.000,Montgomery,AL,Passenger,0,1,1,39,40,2.5,325
2020-07-31T00:00:00.000,New London,CT,Passenger,1,2,3,249,252,1.19047619,326
2020-07-31T00:00:00.000,Orange,CA,Passenger,7,2,9,485,494,1.821862348,327
2020-06-30T00:00:00.000,Benton,WA,Passenger,359,321,680,134252,134932,0.503957549,328
2020-06-30T00:00:00.000,Boone,MO,Passenger,0,1,1,11,12,8.333333333,329
2020-06-30T00:00:00.000,Boulder,CO,Passenger,0,1,1,42,43,2.325581395,330
2020-06-30T00:00:00.000,Broward,FL,Passenger,2,1,3,106,109,2.752293578,331
2020-06-30T00:00:00.000,Bucks,PA,Passenger,1,0,1,19,20,5,332
2020-06-30T00:00:00.000,Cape May,NJ,Passenger,0,1,1,13,14,7.142857143,333
2020-06-30T00:00:00.000,Cascade,MT,Passenger,0,1,1,56,57,1.754385965,334
2020-06-30T00:00:00.000,Clallam,WA,Passenger,228,168,396,50100,50496,0.784220532,335
2020-06-30T00:00:00.000,Cowlitz,WA,Truck,0,0,0,28872,28872,0,336
2020-06-30T00:00:00.000,Dakota,MN,Passenger,0,1,1,31,32,3.125,337
2020-06-30T00:00:00.000,DeKalb,IN,Passenger,1,0,1,1,2,50,338
2020-05-31T00:00:00.000,Kootenai,ID,Passenger,1,0,1,213,214,0.46728972,339
2020-05-31T00:00:00.000,Lewis,WA,Passenger,99,108,207,58244,58451,0.354142786,340
2020-05-31T00:00:00.000,Mason,WA,Passenger,157,137,294,47193,47487,0.619116811,341
2020-05-31T00:00:00.000,Mason,WA,Truck,0,0,0,20509,20509,0,342
2020-05-31T00:00:00.000,Newport,RI,Passenger,1,0,1,84,85,1.176470588,343
2020-05-31T00:00:00.000,Norfolk,VA,Passenger,2,2,4,352,356,1.123595506,344
2020-05-31T00:00:00.000,Nueces,TX,Passenger,1,0,1,78,79,1.265822785,345
2020-07-31T00:00:00.000,Harrison,MS,Passenger,1,0,1,54,55,1.818181818,346
2020-07-31T00:00:00.000,Klickitat,WA,Passenger,56,43,99,15115,15214,0.650716445,347
2020-07-31T00:00:00.000,Lake,IL,Passenger,1,0,1,169,170,0.588235294,348
2020-09-30T00:00:00.000,Denver,CO,Passenger,1,0,1,110,111,0.900900901,349
2020-09-30T00:00:00.000,Deschutes,OR,Passenger,1,0,1,122,123,0.81300813,350
2020-09-30T00:00:00.000,Douglas,WA,Passenger,79,45,124,28048,28172,0.440153344,351
2020-09-30T00:00:00.000,Douglas,WA,Truck,0,0,0,12379,12379,0,352
2020-09-30T00:00:00.000,El Dorado,CA,Passenger,1,0,1,34,35,2.857142857,353
2020-09-30T00:00:00.000,Frederick,MD,Passenger,1,1,2,73,75,2.666666667,354
2020-09-30T00:00:00.000,Grant,WA,Passenger,67,80,147,65588,65735,0.223625162,355
2020-09-30T00:00:00.000,Gwinnett,GA,Passenger,1,0,1,73,74,1.351351351,356
2020-07-31T00:00:00.000,Bradley,TN,Passenger,1,0,1,3,4,25,357
2020-07-31T00:00:00.000,Bucks,PA,Passenger,1,0,1,20,21,4.761904762,358
2020-07-31T00:00:00.000,Camden,NJ,Passenger,0,1,1,22,23,4.347826087,359
2020-07-31T00:00:00.000,Cape May,NJ,Passenger,0,1,1,13,14,7.142857143,360
2020-07-31T00:00:00.000,Charles,MD,Passenger,1,1,2,75,77,2.597402597,361
2020-07-31T00:00:00.000,Charleston,SC,Passenger,2,0,2,98,100,2,362
2020-07-31T00:00:00.000,Clark,NV,Passenger,2,3,5,671,676,0.73964497,363
2020-07-31T00:00:00.000,Clay,FL,Passenger,0,1,1,82,83,1.204819277,364
2020-07-31T00:00:00.000,Douglas,WA,Truck,0,0,0,12351,12351,0,365
2020-07-31T00:00:00.000,DuPage,IL,Passenger,3,0,3,56,59,5.084745763,366
2020-07-31T00:00:00.000,Duval,FL,Passenger,0,2,2,363,365,0.547945205,367
2020-09-30T00:00:00.000,Juneau,AK,Passenger,0,1,1,28,29,3.448275862,368
2020-09-30T00:00:00.000,Lake,FL,Passenger,1,0,1,23,24,4.166666667,369
2020-09-30T00:00:00.000,Maui,HI,Passenger,1,0,1,29,30,3.333333333,370
2020-07-31T00:00:00.000,Manassas,VA,Passenger,0,1,1,4,5,20,371
2020-07-31T00:00:00.000,Maricopa,AZ,Passenger,5,7,12,1368,1380,0.869565217,372
2020-07-31T00:00:00.000,Maui,HI,Passenger,1,0,1,32,33,3.03030303,373
2020-07-31T00:00:00.000,Prince George's,MD,Passenger,1,1,2,154,156,1.282051282,374
2020-05-31T00:00:00.000,Pinal,AZ,Passenger,1,0,1,183,184,0.543478261,375
2020-05-31T00:00:00.000,Prince William,VA,Passenger,2,3,5,221,226,2.212389381,376
2020-05-31T00:00:00.000,RÃ­o Grande,PR,Passenger,1,0,1,1,2,50,377
2020-05-31T00:00:00.000,Skamania,WA,Passenger,30,16,46,8527,8573,0.536568296,378
2020-05-31T00:00:00.000,Solano,CA,Passenger,1,0,1,213,214,0.46728972,379
2020-05-31T00:00:00.000,Tulsa,OK,Passenger,1,1,2,43,45,4.444444444,380
2020-05-31T00:00:00.000,Utah,UT,Passenger,0,1,1,129,130,0.769230769,381
2020-05-31T00:00:00.000,Whatcom,WA,Passenger,1061,497,1558,149330,150888,1.032553947,382
2020-06-30T00:00:00.000,Fairfax,VA,Passenger,4,3,7,734,741,0.944669366,383
2020-06-30T00:00:00.000,Howard,MD,Passenger,0,1,1,72,73,1.369863014,384
2020-06-30T00:00:00.000,Island,WA,Truck,1,0,1,21216,21217,0.004713202,385
2020-06-30T00:00:00.000,Kitsap,WA,Passenger,1331,686,2017,179842,181859,1.109101007,386
2020-06-30T00:00:00.000,Klickitat,WA,Truck,0,0,0,8102,8102,0,387
2020-04-30T00:00:00.000,Pacific,WA,Passenger,30,34,64,15840,15904,0.402414487,388
2020-04-30T00:00:00.000,Pierce,WA,Truck,0,0,0,141154,141154,0,389
2020-04-30T00:00:00.000,Pinellas,FL,Passenger,1,1,2,107,109,1.834862385,390
2020-04-30T00:00:00.000,Polk,FL,Passenger,1,0,1,66,67,1.492537313,391
2020-04-30T00:00:00.000,Powhatan,VA,Passenger,1,0,1,0,1,100,392
2020-04-30T00:00:00.000,Richmond,GA,Passenger,0,1,1,92,93,1.075268817,393
2020-04-30T00:00:00.000,San Mateo,CA,Passenger,0,1,1,114,115,0.869565217,394
2020-04-30T00:00:00.000,Shasta,CA,Passenger,1,0,1,37,38,2.631578947,395
2020-04-30T00:00:00.000,Skagit,WA,Truck,1,0,1,32389,32390,0.003087373,396
2020-04-30T00:00:00.000,Spokane,WA,Truck,1,0,1,97410,97411,0.001026578,397
2020-04-30T00:00:00.000,Stevens,WA,Passenger,33,33,66,30966,31032,0.212683681,398
2020-04-30T00:00:00.000,Stevens,WA,Truck,0,0,0,18613,18613,0,399
2020-04-30T00:00:00.000,Suffolk,MA,Passenger,0,2,2,36,38,5.263157895,400
2020-07-31T00:00:00.000,Richland,SC,Passenger,0,1,1,156,157,0.636942675,401
2020-07-31T00:00:00.000,Riverside,CA,Passenger,3,1,4,610,614,0.651465798,402
2020-07-31T00:00:00.000,Salt Lake,UT,Passenger,0,1,1,177,178,0.561797753,403
2020-07-31T00:00:00.000,San Juan,WA,Passenger,311,94,405,13959,14364,2.819548872,404
2020-07-31T00:00:00.000,San Juan,WA,Truck,0,0,0,5842,5842,0,405
2020-07-31T00:00:00.000,Solano,CA,Passenger,1,0,1,214,215,0.465116279,406
2020-07-31T00:00:00.000,Stafford,VA,Passenger,1,1,2,88,90,2.222222222,407
2020-07-31T00:00:00.000,Sumter,FL,Passenger,0,1,1,9,10,10,408
2020-07-31T00:00:00.000,Thurston,WA,Truck,0,0,0,55907,55907,0,409
2020-06-30T00:00:00.000,Allegheny,PA,Passenger,1,0,1,68,69,1.449275362,410
2020-06-30T00:00:00.000,Bell,TX,Passenger,0,1,1,421,422,0.236966825,411
2020-06-30T00:00:00.000,Carson City,NV,Passenger,1,0,1,11,12,8.333333333,412
2020-09-30T00:00:00.000,New Haven,CT,Passenger,0,2,2,34,36,5.555555556,413
2020-09-30T00:00:00.000,Palm Beach,FL,Passenger,0,1,1,73,74,1.351351351,414
2020-09-30T00:00:00.000,Powhatan,VA,Passenger,1,0,1,0,1,100,415
2020-09-30T00:00:00.000,Richmond,GA,Passenger,0,1,1,87,88,1.136363636,416
2020-09-30T00:00:00.000,Rockingham,NH,Passenger,1,0,1,24,25,4,417
2020-09-30T00:00:00.000,Rogers,OK,Passenger,1,0,1,5,6,16.66666667,418
2020-09-30T00:00:00.000,San Diego,CA,Passenger,16,5,21,2769,2790,0.752688172,419
2020-08-31T00:00:00.000,Broward,FL,Passenger,2,1,3,105,108,2.777777778,420
2020-08-31T00:00:00.000,Cascade,MT,Passenger,0,1,1,56,57,1.754385965,421
2020-07-31T00:00:00.000,Randolph,NC,Passenger,1,0,1,8,9,11.11111111,422
2020-07-31T00:00:00.000,San Diego,CA,Passenger,15,5,20,2795,2815,0.710479574,423
2020-07-31T00:00:00.000,Sedgwick,KS,Passenger,1,1,2,93,95,2.105263158,424
2020-07-31T00:00:00.000,Thurston,WA,Passenger,1177,743,1920,197203,199123,0.96422814,425
2020-07-31T00:00:00.000,Washtenaw,MI,Passenger,1,0,1,32,33,3.03030303,426
2020-04-30T00:00:00.000,Tarrant,TX,Passenger,1,0,1,175,176,0.568181818,427
2020-04-30T00:00:00.000,Whatcom,WA,Truck,3,0,3,42838,42841,0.007002638,428
2020-05-31T00:00:00.000,Ada,ID,Passenger,0,1,1,267,268,0.373134328,429
2020-05-31T00:00:00.000,Alexandria,VA,Passenger,1,0,1,140,141,0.709219858,430
2020-05-31T00:00:00.000,Bartow,GA,Passenger,0,1,1,2,3,33.33333333,431
2020-07-31T00:00:00.000,Jefferson,WA,Passenger,249,142,391,24740,25131,1.55584736,432
2020-07-31T00:00:00.000,Kent,MI,Passenger,0,1,1,23,24,4.166666667,433
2020-07-31T00:00:00.000,Kitsap,WA,Truck,0,0,0,54159,54159,0,434
2020-07-31T00:00:00.000,Lewis,WA,Passenger,107,115,222,58140,58362,0.380384497,435
2020-06-30T00:00:00.000,Kootenai,ID,Passenger,1,0,1,209,210,0.476190476,436
2020-06-30T00:00:00.000,Lincoln,WA,Truck,0,0,0,4624,4624,0,437
2020-06-30T00:00:00.000,Montgomery,AL,Passenger,0,1,1,39,40,2.5,438
2020-06-30T00:00:00.000,Montgomery,OH,Passenger,0,1,1,47,48,2.083333333,439
2020-06-30T00:00:00.000,Orange,CA,Passenger,7,2,9,495,504,1.785714286,440
2020-06-30T00:00:00.000,Pierce,WA,Truck,0,0,0,142186,142186,0,441
2020-08-31T00:00:00.000,Asotin,WA,Truck,0,0,0,6666,6666,0,442
2020-08-31T00:00:00.000,Chesapeake,VA,Passenger,0,2,2,420,422,0.473933649,443
2020-07-31T00:00:00.000,Nassau,FL,Passenger,1,0,1,33,34,2.941176471,444
2020-07-31T00:00:00.000,Norfolk,VA,Passenger,2,2,4,353,357,1.120448179,445
2020-07-31T00:00:00.000,Nueces,TX,Passenger,1,0,1,80,81,1.234567901,446
2020-07-31T00:00:00.000,Palm Beach,FL,Passenger,0,1,1,75,76,1.315789474,447
2020-09-30T00:00:00.000,Stevens,WA,Truck,0,0,0,18704,18704,0,448
2020-09-30T00:00:00.000,Suffolk,MA,Passenger,0,2,2,34,36,5.555555556,449
2020-10-31T00:00:00.000,Adams,WA,Passenger,8,7,15,12936,12951,0.115821172,450
2020-10-31T00:00:00.000,Arapahoe,CO,Passenger,1,0,1,122,123,0.81300813,451
2020-10-31T00:00:00.000,Asotin,WA,Truck,0,0,0,6684,6684,0,452
2020-05-31T00:00:00.000,Calvert,MD,Passenger,0,2,2,87,89,2.247191011,453
2020-05-31T00:00:00.000,Contra Costa,CA,Passenger,3,1,4,336,340,1.176470588,454
2020-05-31T00:00:00.000,Dallas,TX,Passenger,1,0,1,199,200,0.5,455
2020-05-31T00:00:00.000,Pierce,WA,Passenger,2353,1676,4029,547712,551741,0.730233932,456
2020-05-31T00:00:00.000,Pierce,WA,Truck,0,0,0,141333,141333,0,457
2020-05-31T00:00:00.000,Pinellas,FL,Passenger,1,1,2,106,108,1.851851852,458
2020-05-31T00:00:00.000,Portsmouth,VA,Passenger,0,1,1,76,77,1.298701299,459
2020-05-31T00:00:00.000,Putnam,TN,Passenger,0,1,1,3,4,25,460
2020-05-31T00:00:00.000,Santa Cruz,CA,Passenger,1,0,1,35,36,2.777777778,461
2020-05-31T00:00:00.000,Skagit,WA,Passenger,400,216,616,91177,91793,0.671075136,462
2020-05-31T00:00:00.000,Skagit,WA,Truck,1,0,1,32390,32391,0.003087277,463
2020-05-31T00:00:00.000,Snohomish,WA,Passenger,4403,1750,6153,533914,540067,1.139303086,464
2020-05-31T00:00:00.000,Spartanburg,SC,Passenger,0,1,1,42,43,2.325581395,465
2020-05-31T00:00:00.000,Spokane,WA,Passenger,721,478,1199,315075,316274,0.379101665,466
2020-05-31T00:00:00.000,Twin Falls,ID,Passenger,0,1,1,24,25,4,467
2020-05-31T00:00:00.000,Vigo,IN,Passenger,1,0,1,5,6,16.66666667,468
2020-05-31T00:00:00.000,Wahkiakum,WA,Truck,0,0,0,1759,1759,0,469
2020-10-31T00:00:00.000,Bartow,GA,Passenger,0,1,1,2,3,33.33333333,470
2020-10-31T00:00:00.000,Chesapeake,VA,Passenger,0,3,3,411,414,0.724637681,471
2020-10-31T00:00:00.000,Clackamas,OR,Passenger,2,0,2,182,184,1.086956522,472
2020-10-31T00:00:00.000,DeKalb,GA,Passenger,1,0,1,72,73,1.369863014,473
2020-06-30T00:00:00.000,Clackamas,OR,Passenger,2,0,2,195,197,1.015228426,474
2020-06-30T00:00:00.000,Columbia,WA,Passenger,4,3,7,2415,2422,0.289017341,475
2020-06-30T00:00:00.000,Contra Costa,CA,Passenger,3,2,5,331,336,1.488095238,476
2020-06-30T00:00:00.000,Cumberland,NC,Passenger,0,3,3,463,466,0.643776824,477
2020-06-30T00:00:00.000,Douglas,NE,Passenger,0,1,1,54,55,1.818181818,478
2020-06-30T00:00:00.000,Fairbanks North Star,AK,Passenger,0,1,1,100,101,0.99009901,479
2020-06-30T00:00:00.000,Ferry,WA,Truck,0,0,0,3553,3553,0,480
2020-06-30T00:00:00.000,Franklin,WA,Passenger,60,76,136,60647,60783,0.223746771,481
2020-06-30T00:00:00.000,Grays Harbor,WA,Passenger,106,111,217,48143,48360,0.448717949,482
2020-08-31T00:00:00.000,Collin,TX,Passenger,1,1,2,118,120,1.666666667,483
2020-08-31T00:00:00.000,Columbia,WA,Truck,0,0,0,1527,1527,0,484
2020-08-31T00:00:00.000,DeKalb,GA,Passenger,1,0,1,75,76,1.315789474,485
2020-08-31T00:00:00.000,Franklin,WA,Truck,0,0,0,20189,20189,0,486
2020-08-31T00:00:00.000,Grays Harbor,WA,Truck,0,0,0,21031,21031,0,487
2020-07-31T00:00:00.000,Pinal,AZ,Passenger,1,0,1,175,176,0.568181818,488
2020-07-31T00:00:00.000,Prince William,VA,Passenger,2,3,5,224,229,2.183406114,489
2020-07-31T00:00:00.000,Rockingham,NH,Passenger,1,0,1,23,24,4.166666667,490
2020-07-31T00:00:00.000,Rogers,OK,Passenger,1,0,1,5,6,16.66666667,491
2020-07-31T00:00:00.000,Santa Cruz,CA,Passenger,1,0,1,32,33,3.03030303,492
2020-07-31T00:00:00.000,Snohomish,WA,Passenger,4584,1777,6361,535649,542010,1.173594583,493
2020-05-31T00:00:00.000,Ferry,WA,Passenger,5,3,8,4331,4339,0.18437428,494
2020-05-31T00:00:00.000,Fort Bend,TX,Passenger,1,0,1,47,48,2.083333333,495
2020-05-31T00:00:00.000,Grant,WA,Truck,0,0,0,26987,26987,0,496
2020-05-31T00:00:00.000,Hennepin,MN,Passenger,3,0,3,86,89,3.370786517,497
2020-05-31T00:00:00.000,Juneau,AK,Passenger,0,2,2,29,31,6.451612903,498
2020-06-30T00:00:00.000,Polk,FL,Passenger,1,0,1,65,66,1.515151515,499
2020-06-30T00:00:00.000,Riverside,CA,Passenger,3,1,4,618,622,0.643086817,500
2020-06-30T00:00:00.000,San Mateo,CA,Passenger,0,1,1,108,109,0.917431193,501
2020-06-30T00:00:00.000,Shasta,CA,Passenger,1,0,1,36,37,2.702702703,502
2020-06-30T00:00:00.000,Shelby,OH,Passenger,0,1,1,1,2,50,503
2020-06-30T00:00:00.000,Skagit,WA,Truck,1,0,1,32473,32474,0.003079387,504
2020-06-30T00:00:00.000,Stevens,WA,Passenger,36,33,69,30654,30723,0.224587443,505
2020-06-30T00:00:00.000,Sumter,FL,Passenger,0,1,1,9,10,10,506
2020-06-30T00:00:00.000,Thurston,WA,Truck,0,0,0,55753,55753,0,507
2020-08-31T00:00:00.000,Chelan,WA,Passenger,248,80,328,54184,54512,0.601702377,508
2020-08-31T00:00:00.000,Chelan,WA,Truck,0,0,0,22676,22676,0,509
2020-08-31T00:00:00.000,Clallam,WA,Passenger,239,171,410,49954,50364,0.814073545,510
2020-08-31T00:00:00.000,Columbia,WA,Passenger,3,3,6,2423,2429,0.247015233,511
2020-08-31T00:00:00.000,Cowlitz,WA,Passenger,152,120,272,72139,72411,0.375633536,512
2020-08-31T00:00:00.000,Dakota,MN,Passenger,0,1,1,32,33,3.03030303,513
2020-08-31T00:00:00.000,Fairbanks North Star,AK,Passenger,0,1,1,99,100,1,514
2020-08-31T00:00:00.000,Fairfax,VA,Passenger,4,3,7,749,756,0.925925926,515
2020-08-31T00:00:00.000,Flathead,MT,Passenger,1,0,1,54,55,1.818181818,516
2020-08-31T00:00:00.000,Harrison,MS,Passenger,1,0,1,56,57,1.754385965,517
2020-07-31T00:00:00.000,Tulsa,OK,Passenger,1,1,2,41,43,4.651162791,518
2020-07-31T00:00:00.000,Wahkiakum,WA,Passenger,6,6,12,3001,3013,0.398274145,519
2020-07-31T00:00:00.000,Williams,ND,Passenger,0,1,1,11,12,8.333333333,520
2020-08-31T00:00:00.000,Asotin,WA,Passenger,17,14,31,12358,12389,0.250221971,521
2020-08-31T00:00:00.000,Brevard,FL,Passenger,0,1,1,81,82,1.219512195,522
2020-05-31T00:00:00.000,Washoe,NV,Passenger,1,0,1,102,103,0.970873786,523
2020-05-31T00:00:00.000,Whatcom,WA,Truck,3,0,3,42852,42855,0.00700035,524
2020-06-30T00:00:00.000,Adams,WA,Truck,0,0,0,5262,5262,0,525
2020-06-30T00:00:00.000,Asotin,WA,Passenger,16,12,28,12323,12351,0.226702291,526
2020-06-30T00:00:00.000,Asotin,WA,Truck,0,0,0,6638,6638,0,527
2020-06-30T00:00:00.000,Chesapeake,VA,Passenger,0,2,2,422,424,0.471698113,528
2020-06-30T00:00:00.000,Whatcom,WA,Truck,3,0,3,43014,43017,0.006973987,529
2020-06-30T00:00:00.000,Williams,ND,Passenger,0,1,1,11,12,8.333333333,530
2020-07-31T00:00:00.000,Asotin,WA,Passenger,16,12,28,12380,12408,0.225660864,531
2020-07-31T00:00:00.000,Broward,FL,Passenger,2,1,3,104,107,2.803738318,532
2020-07-31T00:00:00.000,Calvert,MD,Passenger,0,2,2,88,90,2.222222222,533
2020-08-31T00:00:00.000,Jones,GA,Passenger,1,0,1,1,2,50,534
2020-08-31T00:00:00.000,Kern,CA,Passenger,0,1,1,221,222,0.45045045,535
2020-08-31T00:00:00.000,Kitsap,WA,Passenger,1401,699,2100,179673,181773,1.155287089,536
2020-08-31T00:00:00.000,Kittitas,WA,Truck,0,0,0,14555,14555,0,537
2020-08-31T00:00:00.000,Klickitat,WA,Truck,0,0,0,8105,8105,0,538
2020-08-31T00:00:00.000,Middlesex,MA,Passenger,1,1,2,95,97,2.06185567,539
2020-08-31T00:00:00.000,Monroe,IL,Passenger,1,0,1,4,5,20,540
2020-05-31T00:00:00.000,Kittitas,WA,Passenger,102,48,150,29780,29930,0.501169395,541
2020-05-31T00:00:00.000,Larimer,CO,Passenger,1,0,1,51,52,1.923076923,542
2020-05-31T00:00:00.000,Maui,HI,Passenger,1,0,1,32,33,3.03030303,543
2020-05-31T00:00:00.000,Multnomah,OR,Passenger,4,7,11,709,720,1.527777778,544
2020-05-31T00:00:00.000,Nassau,NY,Passenger,4,0,4,33,37,10.81081081,545
2020-05-31T00:00:00.000,New Haven,CT,Passenger,0,2,2,39,41,4.87804878,546
2020-05-31T00:00:00.000,Okanogan,WA,Passenger,34,33,67,25879,25946,0.258228629,547
2020-05-31T00:00:00.000,Oldham,KY,Passenger,0,1,1,4,5,20,548
2020-06-30T00:00:00.000,Harrison,MS,Passenger,1,0,1,56,57,1.754385965,549
2020-06-30T00:00:00.000,Hennepin,MN,Passenger,3,0,3,83,86,3.488372093,550
2020-06-30T00:00:00.000,Kittitas,WA,Passenger,99,47,146,29806,29952,0.487446581,551
2020-06-30T00:00:00.000,Klamath,OR,Passenger,1,0,1,30,31,3.225806452,552
2020-06-30T00:00:00.000,Klickitat,WA,Passenger,53,41,94,15173,15267,0.615707081,553
2020-06-30T00:00:00.000,Lewis,WA,Truck,0,0,0,26212,26212,0,554
2020-06-30T00:00:00.000,Los Angeles,CA,Passenger,7,11,18,986,1004,1.792828685,555
2020-06-30T00:00:00.000,Maricopa,AZ,Passenger,5,7,12,1378,1390,0.863309353,556
2020-06-30T00:00:00.000,DuPage,IL,Passenger,3,0,3,56,59,5.084745763,557
2020-06-30T00:00:00.000,El Paso,CO,Passenger,2,0,2,709,711,0.281293952,558
2020-06-30T00:00:00.000,Erie,NY,Passenger,1,0,1,42,43,2.325581395,559
2020-06-30T00:00:00.000,Franklin,WA,Truck,0,0,0,19974,19974,0,560
2020-06-30T00:00:00.000,Guadalupe,TX,Passenger,1,0,1,63,64,1.5625,561
2020-08-31T00:00:00.000,Island,WA,Passenger,433,273,706,62824,63530,1.111286007,562
2020-08-31T00:00:00.000,Island,WA,Truck,1,0,1,21232,21233,0.00470965,563
2020-08-31T00:00:00.000,Klickitat,WA,Passenger,57,42,99,15044,15143,0.653767417,564
2020-08-31T00:00:00.000,Kootenai,ID,Passenger,1,0,1,206,207,0.483091787,565
2020-08-31T00:00:00.000,Montgomery,OH,Passenger,0,1,1,46,47,2.127659574,566
2020-10-31T00:00:00.000,Ferry,WA,Passenger,8,3,11,4351,4362,0.2521779,567
2020-10-31T00:00:00.000,Franklin,WA,Passenger,73,78,151,61107,61258,0.246498417,568
2020-10-31T00:00:00.000,Franklin,WA,Truck,0,0,0,20376,20376,0,569
2020-10-31T00:00:00.000,Hennepin,MN,Passenger,2,0,2,81,83,2.409638554,570
2020-10-31T00:00:00.000,Howard,MD,Passenger,0,1,1,61,62,1.612903226,571
2020-10-31T00:00:00.000,Kern,CA,Passenger,0,1,1,219,220,0.454545455,572
2020-10-31T00:00:00.000,Kitsap,WA,Passenger,1465,730,2195,179752,181947,1.206395269,573
2020-10-31T00:00:00.000,Kittitas,WA,Passenger,121,50,171,29704,29875,0.572384937,574
2020-10-31T00:00:00.000,Kittitas,WA,Truck,0,0,0,14626,14626,0,575
2020-10-31T00:00:00.000,Klamath,OR,Passenger,1,0,1,29,30,3.333333333,576
2020-06-30T00:00:00.000,Montgomery,PA,Passenger,1,0,1,30,31,3.225806452,577
2020-06-30T00:00:00.000,Prince George's,MD,Passenger,1,1,2,162,164,1.219512195,578
2020-06-30T00:00:00.000,Randolph,NC,Passenger,1,0,1,7,8,12.5,579
2020-08-31T00:00:00.000,Denver,CO,Passenger,1,0,1,111,112,0.892857143,580
2020-08-31T00:00:00.000,Douglas,WA,Truck,0,0,0,12338,12338,0,581
2020-08-31T00:00:00.000,El Paso,CO,Passenger,2,0,2,702,704,0.284090909,582
2020-08-31T00:00:00.000,El Paso,TX,Passenger,3,0,3,410,413,0.726392252,583
2020-08-31T00:00:00.000,Garfield,WA,Truck,0,0,0,994,994,0,584
2020-08-31T00:00:00.000,Guadalupe,TX,Passenger,1,0,1,59,60,1.666666667,585
2020-08-31T00:00:00.000,Gwinnett,GA,Passenger,1,0,1,75,76,1.315789474,586
2020-05-31T00:00:00.000,Sacramento,CA,Passenger,1,0,1,263,264,0.378787879,587
2020-05-31T00:00:00.000,San Francisco,CA,Passenger,1,1,2,92,94,2.127659574,588
2020-05-31T00:00:00.000,Santa Clara,CA,Passenger,6,2,8,302,310,2.580645161,589
2020-05-31T00:00:00.000,Shelby,TN,Passenger,0,1,1,86,87,1.149425287,590
2020-05-31T00:00:00.000,Skamania,WA,Truck,0,0,0,4028,4028,0,591
2020-05-31T00:00:00.000,St. Clair,IL,Passenger,1,0,1,141,142,0.704225352,592
2020-07-31T00:00:00.000,Chelan,WA,Passenger,240,82,322,54239,54561,0.590165136,593
2020-07-31T00:00:00.000,Clallam,WA,Passenger,237,169,406,50063,50469,0.804454219,594
2020-07-31T00:00:00.000,Denton,TX,Passenger,1,0,1,84,85,1.176470588,595
2020-07-31T00:00:00.000,El Paso,CO,Passenger,2,0,2,710,712,0.280898876,596
2020-07-31T00:00:00.000,Fairfax,VA,Passenger,4,3,7,742,749,0.934579439,597
2020-10-31T00:00:00.000,Larimer,CO,Passenger,1,0,1,51,52,1.923076923,598
2020-10-31T00:00:00.000,Lincoln,WA,Passenger,5,10,15,7616,7631,0.196566636,599
2020-10-31T00:00:00.000,Loudoun,VA,Passenger,1,0,1,80,81,1.234567901,600
2020-10-31T00:00:00.000,Montgomery,PA,Passenger,1,0,1,25,26,3.846153846,601
2020-10-31T00:00:00.000,New London,CT,Passenger,1,2,3,246,249,1.204819277,602
2020-10-31T00:00:00.000,Orange,CA,Passenger,5,3,8,461,469,1.70575693,603
2020-08-31T00:00:00.000,Montgomery,TX,Passenger,1,0,1,49,50,2,604
2020-08-31T00:00:00.000,Moore,NC,Passenger,0,2,2,155,157,1.27388535,605
2020-08-31T00:00:00.000,New London,CT,Passenger,1,2,3,248,251,1.195219124,606
2020-08-31T00:00:00.000,Okaloosa,FL,Passenger,0,1,1,140,141,0.709219858,607
2020-08-31T00:00:00.000,Orange,CA,Passenger,6,2,8,478,486,1.646090535,608
2020-08-31T00:00:00.000,Pacific,WA,Truck,0,0,0,7725,7725,0,609
2020-08-31T00:00:00.000,Pend Oreille,WA,Truck,0,0,0,5750,5750,0,610
2020-08-31T00:00:00.000,Pima,AZ,Passenger,3,1,4,333,337,1.18694362,611
2020-08-31T00:00:00.000,Placer,CA,Passenger,1,0,1,80,81,1.234567901,612
2020-08-31T00:00:00.000,Ramsey,MN,Passenger,1,0,1,39,40,2.5,613
2020-08-31T00:00:00.000,Riverside,CA,Passenger,3,0,3,609,612,0.490196078,614
2020-08-31T00:00:00.000,Saginaw,MI,Passenger,1,0,1,9,10,10,615
2020-08-31T00:00:00.000,San Juan,WA,Truck,0,0,0,5836,5836,0,616
2020-06-30T00:00:00.000,Jefferson,CO,Passenger,0,1,1,62,63,1.587301587,617
2020-06-30T00:00:00.000,Jones,GA,Passenger,1,0,1,1,2,50,618
2020-06-30T00:00:00.000,Kern,CA,Passenger,0,1,1,225,226,0.442477876,619
2020-06-30T00:00:00.000,Kitsap,WA,Truck,0,0,0,54080,54080,0,620
2020-06-30T00:00:00.000,Kittitas,WA,Truck,0,0,0,14588,14588,0,621
2020-06-30T00:00:00.000,Lewis,WA,Passenger,102,111,213,58179,58392,0.364775997,622
2020-07-31T00:00:00.000,Grant,WA,Truck,0,0,0,27180,27180,0,623
2020-07-31T00:00:00.000,Juneau,AK,Passenger,0,1,1,29,30,3.333333333,624
2020-07-31T00:00:00.000,King,WA,Truck,7,1,8,182978,182986,0.004371919,625
2020-07-31T00:00:00.000,Lee,FL,Passenger,1,0,1,45,46,2.173913043,626
2020-08-31T00:00:00.000,Jefferson,WA,Passenger,249,144,393,24655,25048,1.568987544,627
2020-08-31T00:00:00.000,King,WA,Truck,5,1,6,183339,183345,0.003272519,628
2020-08-31T00:00:00.000,Lake,FL,Passenger,1,0,1,22,23,4.347826087,629
2020-08-31T00:00:00.000,Lincoln,WA,Passenger,5,11,16,7632,7648,0.209205021,630
2020-07-31T00:00:00.000,New Haven,CT,Passenger,0,2,2,36,38,5.263157895,631
2020-07-31T00:00:00.000,Oldham,KY,Passenger,0,1,1,4,5,20,632
2020-07-31T00:00:00.000,Owyhee,ID,Passenger,1,0,1,3,4,25,633
2020-07-31T00:00:00.000,RÃ­o Grande,PR,Passenger,1,0,1,1,2,50,634
2020-06-30T00:00:00.000,San Juan,WA,Passenger,302,93,395,13968,14363,2.750121841,635
2020-06-30T00:00:00.000,Santa Clara,CA,Passenger,6,2,8,297,305,2.62295082,636
2020-06-30T00:00:00.000,Sedgwick,KS,Passenger,1,1,2,89,91,2.197802198,637
2020-06-30T00:00:00.000,Snohomish,WA,Truck,0,0,0,123946,123946,0,638
2020-06-30T00:00:00.000,Solano,CA,Passenger,1,0,1,216,217,0.460829493,639
2020-06-30T00:00:00.000,Spokane,WA,Truck,1,0,1,98342,98343,0.001016849,640
2020-06-30T00:00:00.000,Thurston,WA,Passenger,1145,735,1880,196942,198822,0.945569404,641
2020-06-30T00:00:00.000,Washtenaw,MI,Passenger,1,0,1,32,33,3.03030303,642
2020-08-31T00:00:00.000,New York,NY,Passenger,1,0,1,59,60,1.666666667,643
2020-08-31T00:00:00.000,Pierce,WA,Passenger,2521,1704,4225,552635,556860,0.758718529,644
2020-08-31T00:00:00.000,Pierce,WA,Truck,0,0,0,143420,143420,0,645
2020-08-31T00:00:00.000,Pinellas,FL,Passenger,1,1,2,102,104,1.923076923,646
2020-08-31T00:00:00.000,Polk,FL,Passenger,1,0,1,62,63,1.587301587,647
2020-08-31T00:00:00.000,Portsmouth,VA,Passenger,0,1,1,75,76,1.315789474,648
2020-08-31T00:00:00.000,Prince George's,MD,Passenger,2,1,3,152,155,1.935483871,649
2020-08-31T00:00:00.000,Randolph,NC,Passenger,1,0,1,8,9,11.11111111,650
2020-08-31T00:00:00.000,San Mateo,CA,Passenger,0,1,1,103,104,0.961538462,651
2020-08-31T00:00:00.000,Shelby,OH,Passenger,0,1,1,1,2,50,652
2020-08-31T00:00:00.000,Skagit,WA,Passenger,432,222,654,91263,91917,0.711511472,653
2020-08-31T00:00:00.000,Skagit,WA,Truck,1,0,1,32637,32638,0.003063913,654
2020-08-31T00:00:00.000,Spokane,WA,Passenger,781,504,1285,317546,318831,0.403034837,655
2020-05-31T00:00:00.000,Travis,TX,Passenger,2,1,3,176,179,1.675977654,656
2020-05-31T00:00:00.000,Walla Walla,WA,Passenger,70,62,132,35828,35960,0.367074527,657
2020-05-31T00:00:00.000,Walla Walla,WA,Truck,0,0,0,13669,13669,0,658
2020-05-31T00:00:00.000,Whitman,WA,Passenger,45,48,93,22177,22270,0.417602155,659
2020-05-31T00:00:00.000,Yakima,WA,Truck,0,0,0,59579,59579,0,660
2020-06-30T00:00:00.000,,,Passenger,5,1,6,361,367,1.634877384,661
2020-06-30T00:00:00.000,Brevard,FL,Passenger,0,1,1,82,83,1.204819277,662
2020-08-31T00:00:00.000,Stafford,VA,Passenger,1,1,2,88,90,2.222222222,663
2020-08-31T00:00:00.000,Suffolk,VA,Passenger,1,0,1,120,121,0.826446281,664
2020-08-31T00:00:00.000,Valencia,NM,Passenger,1,0,1,6,7,14.28571429,665
2020-08-31T00:00:00.000,Ventura,CA,Passenger,1,2,3,286,289,1.038062284,666
2020-08-31T00:00:00.000,Yakima,WA,Passenger,146,122,268,166150,166418,0.161040272,667
2020-09-30T00:00:00.000,Adams,WA,Passenger,8,7,15,12918,12933,0.115982371,668
2020-09-30T00:00:00.000,Arapahoe,CO,Passenger,1,0,1,127,128,0.78125,669
2020-09-30T00:00:00.000,Arlington,VA,Passenger,0,2,2,144,146,1.369863014,670
2020-07-31T00:00:00.000,Alexandria,VA,Passenger,2,0,2,138,140,1.428571429,671
2020-07-31T00:00:00.000,Collin,TX,Passenger,1,1,2,118,120,1.666666667,672
2020-06-30T00:00:00.000,Montgomery,TX,Passenger,1,0,1,50,51,1.960784314,673
2020-06-30T00:00:00.000,New London,CT,Passenger,1,2,3,254,257,1.167315175,674
2020-06-30T00:00:00.000,Nueces,TX,Passenger,1,0,1,79,80,1.25,675
2020-06-30T00:00:00.000,Owyhee,ID,Passenger,1,0,1,3,4,25,676
2020-06-30T00:00:00.000,Portsmouth,VA,Passenger,0,1,1,77,78,1.282051282,677
2020-06-30T00:00:00.000,Richland,SC,Passenger,0,1,1,161,162,0.617283951,678
2020-06-30T00:00:00.000,Saginaw,MI,Passenger,1,0,1,10,11,9.090909091,679
2020-06-30T00:00:00.000,San Juan,WA,Truck,0,0,0,5852,5852,0,680
2020-08-31T00:00:00.000,Montgomery,PA,Passenger,1,0,1,27,28,3.571428571,681
2020-08-31T00:00:00.000,Owyhee,ID,Passenger,1,0,1,3,4,25,682
2020-08-31T00:00:00.000,Pacific,WA,Passenger,32,33,65,15711,15776,0.412018256,683
2020-08-31T00:00:00.000,Palm Beach,FL,Passenger,0,1,1,74,75,1.333333333,684
2020-08-31T00:00:00.000,Penobscot,ME,Passenger,0,1,1,14,15,6.666666667,685
2020-08-31T00:00:00.000,Pinal,AZ,Passenger,1,0,1,176,177,0.564971751,686
2020-08-31T00:00:00.000,Prince William,VA,Passenger,2,2,4,224,228,1.754385965,687
2020-08-31T00:00:00.000,Queens,NY,Passenger,1,0,1,49,50,2,688
2020-08-31T00:00:00.000,Rockingham,NH,Passenger,1,0,1,23,24,4.166666667,689
2020-08-31T00:00:00.000,Rogers,OK,Passenger,1,0,1,5,6,16.66666667,690
2020-10-31T00:00:00.000,Riverside,CA,Passenger,4,1,5,601,606,0.825082508,691
2020-10-31T00:00:00.000,Sacramento,CA,Passenger,1,0,1,241,242,0.41322314,692
2020-10-31T00:00:00.000,Salt Lake,UT,Passenger,0,2,2,170,172,1.162790698,693
2020-10-31T00:00:00.000,San Juan,WA,Passenger,340,103,443,13971,14414,3.07340086,694
2020-10-31T00:00:00.000,San Juan,WA,Truck,0,0,0,5862,5862,0,695
2020-10-31T00:00:00.000,Santa Clara,CA,Passenger,4,2,6,268,274,2.189781022,696
2020-10-31T00:00:00.000,Solano,CA,Passenger,1,0,1,211,212,0.471698113,697
2020-10-31T00:00:00.000,Stafford,VA,Passenger,1,1,2,91,93,2.150537634,698
2020-10-31T00:00:00.000,Suffolk,VA,Passenger,1,0,1,121,122,0.819672131,699
2020-10-31T00:00:00.000,Sumter,FL,Passenger,0,1,1,10,11,9.090909091,700
2020-10-31T00:00:00.000,Thurston,WA,Truck,0,0,0,56322,56322,0,701
2020-10-31T00:00:00.000,Travis,TX,Passenger,2,1,3,164,167,1.796407186,702
2020-07-31T00:00:00.000,Cowlitz,WA,Passenger,146,117,263,72243,72506,0.362728602,703
2020-07-31T00:00:00.000,Dallas,TX,Passenger,1,0,1,189,190,0.526315789,704
2020-07-31T00:00:00.000,Flathead,MT,Passenger,1,0,1,54,55,1.818181818,705
2020-07-31T00:00:00.000,Fort Bend,TX,Passenger,1,0,1,46,47,2.127659574,706
2020-07-31T00:00:00.000,Hamilton,IN,Passenger,1,0,1,40,41,2.43902439,707
2020-07-31T00:00:00.000,Harris,TX,Passenger,1,0,1,219,220,0.454545455,708
2020-08-31T00:00:00.000,St. Louis,MO,Passenger,1,0,1,97,98,1.020408163,709
2020-08-31T00:00:00.000,Stevens,WA,Truck,0,0,0,18653,18653,0,710
2020-08-31T00:00:00.000,Utah,UT,Passenger,0,1,1,126,127,0.787401575,711
2020-08-31T00:00:00.000,Whitman,WA,Truck,0,0,0,8483,8483,0,712
2020-08-31T00:00:00.000,Williamson,TX,Passenger,0,1,1,124,125,0.8,713
2020-09-30T00:00:00.000,Allegheny,PA,Passenger,1,0,1,65,66,1.515151515,714
2020-09-30T00:00:00.000,Bartow,GA,Passenger,0,1,1,2,3,33.33333333,715
2020-09-30T00:00:00.000,Bradley,TN,Passenger,1,0,1,1,2,50,716
2020-09-30T00:00:00.000,Bucks,PA,Passenger,1,0,1,19,20,5,717
2020-09-30T00:00:00.000,Cape May,NJ,Passenger,0,1,1,11,12,8.333333333,718
2020-09-30T00:00:00.000,Charleston,SC,Passenger,2,0,2,93,95,2.105263158,719
2020-09-30T00:00:00.000,Clallam,WA,Passenger,245,173,418,49893,50311,0.830832224,720
2020-09-30T00:00:00.000,Clark,WA,Passenger,2174,1096,3270,318462,321732,1.016373876,721
2020-09-30T00:00:00.000,DeKalb,GA,Passenger,1,0,1,75,76,1.315789474,722
2020-06-30T00:00:00.000,Camden,NJ,Passenger,0,1,1,21,22,4.545454545,723
2020-06-30T00:00:00.000,Clark,NV,Passenger,2,3,5,677,682,0.73313783,724
2020-06-30T00:00:00.000,Collin,TX,Passenger,1,1,2,117,119,1.680672269,725
2020-06-30T00:00:00.000,Columbia,WA,Truck,0,0,0,1533,1533,0,726
2020-06-30T00:00:00.000,Denver,CO,Passenger,1,0,1,115,116,0.862068966,727
2020-06-30T00:00:00.000,Deschutes,OR,Passenger,3,0,3,130,133,2.255639098,728
2020-06-30T00:00:00.000,Douglas,WA,Truck,0,0,0,12307,12307,0,729
2020-06-30T00:00:00.000,Duval,FL,Passenger,0,2,2,361,363,0.550964187,730
2020-08-31T00:00:00.000,Spokane,WA,Truck,1,0,1,99459,99460,0.001005429,731
2020-08-31T00:00:00.000,Stevens,WA,Passenger,35,36,71,30495,30566,0.232284237,732
2020-08-31T00:00:00.000,Whatcom,WA,Truck,3,0,3,43284,43287,0.006930487,733
2020-09-30T00:00:00.000,Adams,WA,Truck,0,0,0,5308,5308,0,734
2020-09-30T00:00:00.000,Alameda,CA,Passenger,2,0,2,262,264,0.757575758,735
2020-09-30T00:00:00.000,Asotin,WA,Truck,0,0,0,6692,6692,0,736
2020-06-30T00:00:00.000,Snohomish,WA,Passenger,4435,1767,6202,534579,540781,1.146859819,737
2020-06-30T00:00:00.000,Spokane,WA,Passenger,730,486,1216,315509,316725,0.383929276,738
2020-06-30T00:00:00.000,St. Louis,MO,Passenger,1,0,1,97,98,1.020408163,739
2020-06-30T00:00:00.000,Stafford,VA,Passenger,1,1,2,89,91,2.197802198,740
2020-06-30T00:00:00.000,Suffolk,VA,Passenger,1,0,1,122,123,0.81300813,741
2020-06-30T00:00:00.000,Valencia,NM,Passenger,1,0,1,5,6,16.66666667,742
2020-06-30T00:00:00.000,Ventura,CA,Passenger,1,2,3,287,290,1.034482759,743
2020-06-30T00:00:00.000,Whitman,WA,Truck,0,0,0,8511,8511,0,744
2020-06-30T00:00:00.000,Williamson,TX,Passenger,0,1,1,133,134,0.746268657,745
2020-07-31T00:00:00.000,Shelby,OH,Passenger,0,1,1,1,2,50,746
2020-07-31T00:00:00.000,Skamania,WA,Passenger,31,19,50,8430,8480,0.589622642,747
2020-07-31T00:00:00.000,Spokane,WA,Passenger,753,490,1243,316493,317736,0.391205277,748
2020-07-31T00:00:00.000,St. Clair,IL,Passenger,1,0,1,140,141,0.709219858,749
2020-07-31T00:00:00.000,St. Louis,MO,Passenger,1,0,1,98,99,1.01010101,750
2020-07-31T00:00:00.000,Walla Walla,WA,Passenger,77,65,142,35912,36054,0.393853664,751
2020-07-31T00:00:00.000,Yakima,WA,Truck,0,0,0,60209,60209,0,752
2020-08-31T00:00:00.000,Adams,WA,Truck,0,0,0,5302,5302,0,753
2020-08-31T00:00:00.000,Alameda,CA,Passenger,2,0,2,265,267,0.74906367,754
2020-08-31T00:00:00.000,Anne Arundel,MD,Passenger,0,1,1,394,395,0.253164557,755
2020-10-31T00:00:00.000,Ventura,CA,Passenger,1,1,2,279,281,0.711743772,756
2020-10-31T00:00:00.000,Whitman,WA,Passenger,50,46,96,21987,22083,0.434723543,757
2020-11-30T00:00:00.000,,,Passenger,4,1,5,341,346,1.445086705,758
2020-11-30T00:00:00.000,Bartow,GA,Passenger,0,1,1,2,3,33.33333333,759
2020-11-30T00:00:00.000,Bell,TX,Passenger,0,1,1,397,398,0.251256281,760
2020-11-30T00:00:00.000,Boulder,CO,Passenger,0,1,1,43,44,2.272727273,761
2020-11-30T00:00:00.000,Bucks,PA,Passenger,1,0,1,18,19,5.263157895,762
2020-09-30T00:00:00.000,Anne Arundel,MD,Passenger,1,1,2,394,396,0.505050505,763
2020-09-30T00:00:00.000,Bell,TX,Passenger,0,1,1,405,406,0.246305419,764
2020-09-30T00:00:00.000,Benton,WA,Truck,0,0,0,43091,43091,0,765
2020-09-30T00:00:00.000,Carson City,NV,Passenger,1,0,1,11,12,8.333333333,766
2020-09-30T00:00:00.000,Clackamas,OR,Passenger,2,0,2,181,183,1.092896175,767
2020-09-30T00:00:00.000,Cumberland,NC,Passenger,0,3,3,459,462,0.649350649,768
2020-06-30T00:00:00.000,Gwinnett,GA,Passenger,1,0,1,76,77,1.298701299,769
2020-06-30T00:00:00.000,Jefferson,WA,Passenger,236,139,375,24800,25175,1.489572989,770
2020-06-30T00:00:00.000,Lake,FL,Passenger,1,0,1,22,23,4.347826087,771
2020-07-31T00:00:00.000,Island,WA,Passenger,429,272,701,62883,63584,1.102478611,772
2020-07-31T00:00:00.000,Jefferson,WA,Truck,0,0,0,9545,9545,0,773
2020-07-31T00:00:00.000,Jones,GA,Passenger,1,0,1,1,2,50,774
2020-07-31T00:00:00.000,Mason,WA,Passenger,160,134,294,47385,47679,0.616623671,775
2020-08-31T00:00:00.000,Carroll,NH,Passenger,0,1,1,5,6,16.66666667,776
2020-08-31T00:00:00.000,Charles,MD,Passenger,1,1,2,75,77,2.597402597,777
2020-08-31T00:00:00.000,Clark,WA,Truck,0,0,0,82710,82710,0,778
2020-08-31T00:00:00.000,Clay,FL,Passenger,0,1,1,81,82,1.219512195,779
2020-08-31T00:00:00.000,Denton,TX,Passenger,1,0,1,85,86,1.162790698,780
2020-08-31T00:00:00.000,Douglas,NE,Passenger,0,1,1,51,52,1.923076923,781
2020-08-31T00:00:00.000,DuPage,IL,Passenger,3,0,3,55,58,5.172413793,782
2020-09-30T00:00:00.000,District of Columbia,DC,Passenger,2,1,3,189,192,1.5625,783
2020-09-30T00:00:00.000,Fairfax,VA,Passenger,4,3,7,738,745,0.939597315,784
2020-09-30T00:00:00.000,Ferry,WA,Passenger,8,3,11,4305,4316,0.254865616,785
2020-09-30T00:00:00.000,Fresno,CA,Passenger,1,0,1,177,178,0.561797753,786
2020-09-30T00:00:00.000,Grant,WA,Truck,0,0,0,27306,27306,0,787
2020-09-30T00:00:00.000,Howard,IN,Passenger,0,1,1,3,4,25,788
2020-09-30T00:00:00.000,Howard,MD,Passenger,0,1,1,63,64,1.5625,789
2020-09-30T00:00:00.000,Carroll,MD,Passenger,0,1,1,22,23,4.347826087,790
2020-09-30T00:00:00.000,Charles,MD,Passenger,1,1,2,75,77,2.597402597,791
2020-09-30T00:00:00.000,Clallam,WA,Truck,1,0,1,21776,21777,0.004592001,792
2020-09-30T00:00:00.000,DuPage,IL,Passenger,3,0,3,53,56,5.357142857,793
2020-09-30T00:00:00.000,Erie,NY,Passenger,1,0,1,44,45,2.222222222,794
2020-09-30T00:00:00.000,Franklin,WA,Truck,0,0,0,20291,20291,0,795
2020-09-30T00:00:00.000,Garfield,WA,Passenger,0,1,1,1351,1352,0.073964497,796
2020-08-31T00:00:00.000,Erie,NY,Passenger,1,0,1,43,44,2.272727273,797
2020-08-31T00:00:00.000,Greene,MO,Passenger,0,1,1,32,33,3.03030303,798
2020-08-31T00:00:00.000,Jefferson,CO,Passenger,0,1,1,59,60,1.666666667,799
2020-08-31T00:00:00.000,Kitsap,WA,Truck,0,0,0,54189,54189,0,800
2020-07-31T00:00:00.000,Allegheny,PA,Passenger,1,0,1,69,70,1.428571429,801
2020-07-31T00:00:00.000,Benton,WA,Passenger,373,321,694,134329,135023,0.513986506,802
2020-07-31T00:00:00.000,Brevard,FL,Passenger,0,1,1,84,85,1.176470588,803
2020-07-31T00:00:00.000,Carroll,NH,Passenger,0,1,1,4,5,20,804
2020-07-31T00:00:00.000,Carson City,NV,Passenger,1,0,1,11,12,8.333333333,805
2020-07-31T00:00:00.000,Cascade,MT,Passenger,0,1,1,56,57,1.754385965,806
2020-07-31T00:00:00.000,Columbia,WA,Passenger,4,3,7,2418,2425,0.288659794,807
2020-07-31T00:00:00.000,Cowlitz,WA,Truck,0,0,0,28883,28883,0,808
2020-07-31T00:00:00.000,Cumberland,NC,Passenger,0,3,3,464,467,0.642398287,809
2020-07-31T00:00:00.000,Dakota,MN,Passenger,0,1,1,31,32,3.125,810
2020-11-30T00:00:00.000,Cape May,NJ,Passenger,0,1,1,10,11,9.090909091,811
2020-11-30T00:00:00.000,Clackamas,OR,Passenger,2,0,2,178,180,1.111111111,812
2020-11-30T00:00:00.000,Clark,NV,Passenger,3,3,6,652,658,0.911854103,813
2020-11-30T00:00:00.000,Contra Costa,CA,Passenger,4,2,6,302,308,1.948051948,814
2020-11-30T00:00:00.000,Denton,TX,Passenger,1,0,1,81,82,1.219512195,815
2020-11-30T00:00:00.000,Deschutes,OR,Passenger,1,0,1,119,120,0.833333333,816
2020-11-30T00:00:00.000,Douglas,WA,Passenger,82,43,125,28135,28260,0.442321302,817
2020-11-30T00:00:00.000,Duval,FL,Passenger,0,2,2,356,358,0.558659218,818
2020-11-30T00:00:00.000,Ferry,WA,Truck,0,0,0,3597,3597,0,819
2020-06-30T00:00:00.000,Okaloosa,FL,Passenger,0,1,1,136,137,0.729927007,820
2020-06-30T00:00:00.000,Pacific,WA,Passenger,33,33,66,15757,15823,0.417114327,821
2020-06-30T00:00:00.000,Pacific,WA,Truck,0,0,0,7700,7700,0,822
2020-06-30T00:00:00.000,Palm Beach,FL,Passenger,0,1,1,74,75,1.333333333,823
2020-06-30T00:00:00.000,Pinal,AZ,Passenger,1,0,1,179,180,0.555555556,824
2020-06-30T00:00:00.000,Powhatan,VA,Passenger,1,0,1,0,1,100,825
2020-06-30T00:00:00.000,Prince William,VA,Passenger,2,3,5,222,227,2.202643172,826
2020-06-30T00:00:00.000,Richmond,GA,Passenger,0,1,1,89,90,1.111111111,827
2020-06-30T00:00:00.000,Rockingham,NH,Passenger,1,0,1,24,25,4,828
2020-06-30T00:00:00.000,Rogers,OK,Passenger,1,0,1,6,7,14.28571429,829
2020-09-30T00:00:00.000,Kitsap,WA,Passenger,1427,713,2140,179693,181833,1.176904082,830
2020-09-30T00:00:00.000,Klickitat,WA,Truck,0,0,0,8105,8105,0,831
2020-09-30T00:00:00.000,Larimer,CO,Passenger,1,0,1,52,53,1.886792453,832
2020-09-30T00:00:00.000,Leavenworth,KS,Passenger,0,1,1,131,132,0.757575758,833
2020-09-30T00:00:00.000,Monroe,IL,Passenger,1,0,1,3,4,25,834
2020-09-30T00:00:00.000,Montgomery,OH,Passenger,0,1,1,46,47,2.127659574,835
2020-09-30T00:00:00.000,Moore,NC,Passenger,0,1,1,157,158,0.632911392,836
2020-07-31T00:00:00.000,Montgomery,TX,Passenger,1,0,1,50,51,1.960784314,837
2020-07-31T00:00:00.000,Multnomah,OR,Passenger,4,7,11,694,705,1.560283688,838
2020-07-31T00:00:00.000,Newport,RI,Passenger,1,0,1,81,82,1.219512195,839
2020-07-31T00:00:00.000,Pacific,WA,Truck,0,0,0,7715,7715,0,840
2020-07-31T00:00:00.000,Pend Oreille,WA,Truck,0,0,0,5765,5765,0,841
2020-07-31T00:00:00.000,Pierce,WA,Passenger,2469,1697,4166,551597,555763,0.749600099,842
2020-07-31T00:00:00.000,Placer,CA,Passenger,1,0,1,81,82,1.219512195,843
2020-07-31T00:00:00.000,Portsmouth,VA,Passenger,0,1,1,75,76,1.315789474,844
2020-07-31T00:00:00.000,Ramsey,MN,Passenger,1,0,1,40,41,2.43902439,845
2020-07-31T00:00:00.000,Saginaw,MI,Passenger,1,0,1,10,11,9.090909091,846
2020-07-31T00:00:00.000,San Francisco,CA,Passenger,2,1,3,87,90,3.333333333,847
2020-09-30T00:00:00.000,Douglas,NE,Passenger,0,1,1,50,51,1.960784314,848
2020-09-30T00:00:00.000,Ferry,WA,Truck,0,0,0,3580,3580,0,849
2020-09-30T00:00:00.000,Franklin,WA,Passenger,68,76,144,60931,61075,0.235775686,850
2020-09-30T00:00:00.000,Goochland,VA,Passenger,3,2,5,235,240,2.083333333,851
2020-09-30T00:00:00.000,Grays Harbor,WA,Passenger,115,116,231,48481,48712,0.474215799,852
2020-09-30T00:00:00.000,Greene,MO,Passenger,0,1,1,31,32,3.125,853
2020-09-30T00:00:00.000,Hamilton,IN,Passenger,1,0,1,37,38,2.631578947,854
2020-09-30T00:00:00.000,Harris,TX,Passenger,1,0,1,221,222,0.45045045,855
2020-09-30T00:00:00.000,Honolulu,HI,Passenger,5,1,6,427,433,1.385681293,856
2020-09-30T00:00:00.000,Jefferson,CO,Passenger,0,1,1,58,59,1.694915254,857
2020-09-30T00:00:00.000,Jones,GA,Passenger,1,0,1,1,2,50,858
2020-09-30T00:00:00.000,Kern,CA,Passenger,0,1,1,223,224,0.446428571,859
2020-09-30T00:00:00.000,Kitsap,WA,Truck,0,0,0,54203,54203,0,860
2020-09-30T00:00:00.000,Lake,IL,Passenger,1,0,1,169,170,0.588235294,861
2020-09-30T00:00:00.000,Lewis,WA,Passenger,111,117,228,58310,58538,0.389490587,862
2020-09-30T00:00:00.000,Loudoun,VA,Passenger,1,0,1,82,83,1.204819277,863
2020-08-31T00:00:00.000,Lee,FL,Passenger,1,0,1,43,44,2.272727273,864
2020-08-31T00:00:00.000,Loudoun,VA,Passenger,1,0,1,82,83,1.204819277,865
2020-08-31T00:00:00.000,Pend Oreille,WA,Passenger,8,5,13,9229,9242,0.140662194,866
2020-08-31T00:00:00.000,RÃ­o Grande,PR,Passenger,1,0,1,1,2,50,867
2020-06-30T00:00:00.000,Stevens,WA,Truck,0,0,0,18645,18645,0,868
2020-06-30T00:00:00.000,Suffolk,MA,Passenger,0,2,2,35,37,5.405405405,869
2020-06-30T00:00:00.000,Utah,UT,Passenger,0,1,1,127,128,0.78125,870
2020-11-30T00:00:00.000,Grant,WA,Truck,0,0,0,27424,27424,0,871
2020-11-30T00:00:00.000,Hennepin,MN,Passenger,2,0,2,81,83,2.409638554,872
2020-11-30T00:00:00.000,Howard,IN,Passenger,0,1,1,3,4,25,873
2020-11-30T00:00:00.000,Kittitas,WA,Passenger,125,53,178,29746,29924,0.594840262,874
2020-09-30T00:00:00.000,Manassas,VA,Passenger,0,1,1,4,5,20,875
2020-09-30T00:00:00.000,Montgomery,TX,Passenger,1,0,1,47,48,2.083333333,876
2020-09-30T00:00:00.000,New London,CT,Passenger,1,2,3,246,249,1.204819277,877
2020-09-30T00:00:00.000,Nueces,TX,Passenger,1,0,1,83,84,1.19047619,878
2020-07-31T00:00:00.000,Douglas,NE,Passenger,0,1,1,52,53,1.886792453,879
2020-07-31T00:00:00.000,Fairbanks North Star,AK,Passenger,0,1,1,99,100,1,880
2020-07-31T00:00:00.000,Fulton,GA,Passenger,1,2,3,98,101,2.97029703,881
2020-07-31T00:00:00.000,Grant,WA,Passenger,61,75,136,65289,65425,0.207871609,882
2020-07-31T00:00:00.000,Grays Harbor,WA,Passenger,109,112,221,48285,48506,0.455613739,883
2020-07-31T00:00:00.000,Island,WA,Truck,1,0,1,21239,21240,0.004708098,884
2020-07-31T00:00:00.000,Jefferson,NY,Passenger,0,1,1,209,210,0.476190476,885
2020-09-30T00:00:00.000,Nassau,FL,Passenger,1,0,1,34,35,2.857142857,886
2020-09-30T00:00:00.000,Oldham,KY,Passenger,0,1,1,4,5,20,887
2020-09-30T00:00:00.000,Orange,CA,Passenger,5,3,8,466,474,1.687763713,888
2020-09-30T00:00:00.000,Pima,AZ,Passenger,3,1,4,331,335,1.194029851,889
2020-09-30T00:00:00.000,Polk,FL,Passenger,1,0,1,61,62,1.612903226,890
2020-09-30T00:00:00.000,Riverside,CA,Passenger,3,0,3,607,610,0.491803279,891
2020-09-30T00:00:00.000,Sacramento,CA,Passenger,1,0,1,249,250,0.4,892
2020-09-30T00:00:00.000,San Mateo,CA,Passenger,0,1,1,103,104,0.961538462,893
2020-09-30T00:00:00.000,Sarasota,FL,Passenger,2,0,2,24,26,7.692307692,894
2020-09-30T00:00:00.000,Shelby,OH,Passenger,0,1,1,1,2,50,895
2020-11-30T00:00:00.000,Larimer,CO,Passenger,1,0,1,53,54,1.851851852,896
2020-11-30T00:00:00.000,Maui,HI,Passenger,1,0,1,28,29,3.448275862,897
2020-11-30T00:00:00.000,Missoula,MT,Passenger,1,0,1,59,60,1.666666667,898
2020-11-30T00:00:00.000,Oldham,KY,Passenger,0,1,1,4,5,20,899
2020-08-31T00:00:00.000,Richland,SC,Passenger,0,1,1,153,154,0.649350649,900
2020-08-31T00:00:00.000,Salt Lake,UT,Passenger,0,2,2,178,180,1.111111111,901
2020-08-31T00:00:00.000,Skamania,WA,Passenger,31,21,52,8378,8430,0.616844603,902
2020-08-31T00:00:00.000,Solano,CA,Passenger,1,0,1,213,214,0.46728972,903
2020-08-31T00:00:00.000,Tulsa,OK,Passenger,1,1,2,41,43,4.651162791,904
2020-07-31T00:00:00.000,Ada,ID,Passenger,0,1,1,256,257,0.389105058,905
2020-07-31T00:00:00.000,Bartow,GA,Passenger,0,1,1,2,3,33.33333333,906
2020-07-31T00:00:00.000,Bexar,TX,Passenger,4,5,9,591,600,1.5,907
2020-07-31T00:00:00.000,Chesapeake,VA,Passenger,0,2,2,419,421,0.475059382,908
2020-09-30T00:00:00.000,Jefferson,WA,Truck,0,0,0,9544,9544,0,909
2020-09-30T00:00:00.000,Klamath,OR,Passenger,1,0,1,29,30,3.333333333,910
2020-09-30T00:00:00.000,Lewis,WA,Truck,0,0,0,26450,26450,0,911
2020-09-30T00:00:00.000,Los Angeles,CA,Passenger,9,11,20,974,994,2.012072435,912
2020-09-30T00:00:00.000,Maricopa,AZ,Passenger,5,7,12,1312,1324,0.906344411,913
2020-09-30T00:00:00.000,Mason,WA,Passenger,162,131,293,47471,47764,0.613432711,914
2020-07-31T00:00:00.000,Skagit,WA,Passenger,423,223,646,91318,91964,0.702448784,915
2020-07-31T00:00:00.000,Skamania,WA,Truck,0,0,0,4032,4032,0,916
2020-07-31T00:00:00.000,St. Mary's,MD,Passenger,1,0,1,214,215,0.465116279,917
2020-07-31T00:00:00.000,Valencia,NM,Passenger,1,0,1,6,7,14.28571429,918
2020-07-31T00:00:00.000,Washington,OR,Passenger,1,0,1,419,420,0.238095238,919
2020-07-31T00:00:00.000,Yakima,WA,Passenger,139,119,258,165795,166053,0.15537208,920
2020-08-31T00:00:00.000,,,Passenger,5,1,6,347,353,1.699716714,921
2020-07-31T00:00:00.000,DeKalb,GA,Passenger,1,0,1,74,75,1.333333333,922
2020-07-31T00:00:00.000,Ferry,WA,Passenger,7,3,10,4330,4340,0.230414747,923
2020-07-31T00:00:00.000,Garfield,WA,Truck,0,0,0,988,988,0,924
2020-07-31T00:00:00.000,Guadalupe,TX,Passenger,1,0,1,59,60,1.666666667,925
2020-07-31T00:00:00.000,Hennepin,MN,Passenger,3,0,3,87,90,3.333333333,926
2020-07-31T00:00:00.000,Houston,GA,Passenger,1,0,1,53,54,1.851851852,927
2020-08-31T00:00:00.000,Whatcom,WA,Passenger,1112,513,1625,149230,150855,1.077193331,928
2020-09-30T00:00:00.000,Alexandria,VA,Passenger,2,0,2,135,137,1.459854015,929
2020-09-30T00:00:00.000,Chelan,WA,Truck,0,0,0,22728,22728,0,930
2020-09-30T00:00:00.000,Richland,SC,Passenger,0,1,1,150,151,0.662251656,931
2020-09-30T00:00:00.000,Saginaw,MI,Passenger,1,0,1,9,10,10,932
2020-09-30T00:00:00.000,Salt Lake,UT,Passenger,0,2,2,171,173,1.156069364,933
2020-09-30T00:00:00.000,San Juan,WA,Truck,0,0,0,5846,5846,0,934
2020-09-30T00:00:00.000,Snohomish,WA,Passenger,4695,1810,6505,537268,543773,1.196271238,935
2020-09-30T00:00:00.000,Tulsa,OK,Passenger,1,1,2,39,41,4.87804878,936
2020-09-30T00:00:00.000,Wahkiakum,WA,Passenger,6,6,12,3016,3028,0.396301189,937
2020-09-30T00:00:00.000,Stafford,VA,Passenger,1,1,2,90,92,2.173913043,938
2020-09-30T00:00:00.000,Stevens,WA,Passenger,35,38,73,30419,30492,0.239407058,939
2020-09-30T00:00:00.000,Sumter,FL,Passenger,0,1,1,11,12,8.333333333,940
2020-09-30T00:00:00.000,Thurston,WA,Truck,0,0,0,56149,56149,0,941
2020-09-30T00:00:00.000,Travis,TX,Passenger,2,1,3,165,168,1.785714286,942
2020-09-30T00:00:00.000,Whitman,WA,Passenger,47,47,94,22003,22097,0.425397113,943
2020-10-31T00:00:00.000,Asotin,WA,Passenger,17,14,31,12404,12435,0.249296341,944
2020-11-30T00:00:00.000,Prince William,VA,Passenger,2,2,4,222,226,1.769911504,945
2020-11-30T00:00:00.000,RÃ­o Grande,PR,Passenger,1,0,1,1,2,50,946
2020-11-30T00:00:00.000,Sacramento,CA,Passenger,2,0,2,240,242,0.826446281,947
2020-11-30T00:00:00.000,San Diego,CA,Passenger,15,4,19,2742,2761,0.688156465,948
2020-11-30T00:00:00.000,Sedgwick,KS,Passenger,1,1,2,86,88,2.272727273,949
2020-11-30T00:00:00.000,Skamania,WA,Passenger,33,21,54,8306,8360,0.645933014,950
2020-11-30T00:00:00.000,Thurston,WA,Passenger,1292,763,2055,197274,199329,1.030958867,951
2020-09-30T00:00:00.000,Newport,RI,Passenger,1,0,1,83,84,1.19047619,952
2020-09-30T00:00:00.000,Plaquemines,LA,Passenger,0,1,1,13,14,7.142857143,953
2020-09-30T00:00:00.000,San Juan,WA,Passenger,331,100,431,13909,14340,3.005578801,954
2020-09-30T00:00:00.000,Sedgwick,KS,Passenger,1,1,2,89,91,2.197802198,955
2020-09-30T00:00:00.000,Snohomish,WA,Truck,0,0,0,124947,124947,0,956
2020-09-30T00:00:00.000,Solano,CA,Passenger,1,0,1,211,212,0.471698113,957
2020-07-31T00:00:00.000,Kootenai,ID,Passenger,1,0,1,207,208,0.480769231,958
2020-07-31T00:00:00.000,Lewis,WA,Truck,0,0,0,26288,26288,0,959
2020-07-31T00:00:00.000,Los Angeles,CA,Passenger,7,11,18,980,998,1.803607214,960
2020-07-31T00:00:00.000,Mason,WA,Truck,0,0,0,20716,20716,0,961
2020-07-31T00:00:00.000,Monterey,CA,Passenger,0,1,1,163,164,0.609756098,962
2020-07-31T00:00:00.000,Morris,NJ,Passenger,1,0,1,17,18,5.555555556,963
2020-07-31T00:00:00.000,New York,NY,Passenger,1,0,1,60,61,1.639344262,964
2020-07-31T00:00:00.000,Pacific,WA,Passenger,33,33,66,15768,15834,0.416824555,965
2020-07-31T00:00:00.000,Pend Oreille,WA,Passenger,7,5,12,9245,9257,0.12963163,966
2020-08-31T00:00:00.000,Albemarle,VA,Passenger,1,0,1,20,21,4.761904762,967
2020-08-31T00:00:00.000,Benton,WA,Passenger,380,322,702,134344,135046,0.519822875,968
2020-08-31T00:00:00.000,Bexar,TX,Passenger,4,5,9,583,592,1.52027027,969
2020-08-31T00:00:00.000,Carroll,MD,Passenger,0,1,1,21,22,4.545454545,970
2020-08-31T00:00:00.000,Clallam,WA,Truck,1,0,1,21706,21707,0.004606809,971
2020-08-31T00:00:00.000,Cowlitz,WA,Truck,0,0,0,28916,28916,0,972
2020-10-31T00:00:00.000,Benton,WA,Passenger,403,340,743,134708,135451,0.548537848,973
2020-10-31T00:00:00.000,Cascade,MT,Passenger,0,1,1,54,55,1.818181818,974
2020-10-31T00:00:00.000,Chelan,WA,Truck,0,0,0,22770,22770,0,975
2020-10-31T00:00:00.000,Boone,MO,Passenger,0,1,1,11,12,8.333333333,976
2020-10-31T00:00:00.000,Broward,FL,Passenger,1,1,2,107,109,1.834862385,977
2020-10-31T00:00:00.000,Calvert,MD,Passenger,0,2,2,83,85,2.352941176,978
2020-10-31T00:00:00.000,Camden,NJ,Passenger,0,1,1,22,23,4.347826087,979
2020-10-31T00:00:00.000,Douglas,CO,Passenger,0,1,1,76,77,1.298701299,980
2020-10-31T00:00:00.000,Douglas,WA,Truck,0,0,0,12418,12418,0,981
2020-10-31T00:00:00.000,DuPage,IL,Passenger,3,0,3,52,55,5.454545455,982
2020-10-31T00:00:00.000,El Dorado,CA,Passenger,1,0,1,33,34,2.941176471,983
2020-10-31T00:00:00.000,El Paso,CO,Passenger,2,0,2,694,696,0.287356322,984
2020-09-30T00:00:00.000,Columbia,WA,Passenger,4,3,7,2421,2428,0.28830313,985
2020-09-30T00:00:00.000,Contra Costa,CA,Passenger,4,2,6,314,320,1.875,986
2020-09-30T00:00:00.000,Cowlitz,WA,Passenger,157,120,277,72168,72445,0.382359031,987
2020-09-30T00:00:00.000,El Paso,TX,Passenger,3,0,3,412,415,0.722891566,988
2020-09-30T00:00:00.000,Fairbanks North Star,AK,Passenger,0,1,1,98,99,1.01010101,989
2020-09-30T00:00:00.000,Flathead,MT,Passenger,1,0,1,55,56,1.785714286,990
2020-09-30T00:00:00.000,Fort Bend,TX,Passenger,1,0,1,44,45,2.222222222,991
2020-09-30T00:00:00.000,Garfield,WA,Truck,0,0,0,987,987,0,992
2020-07-31T00:00:00.000,King,WA,Passenger,24912,7751,32663,1371407,1404070,2.326308517,993
2020-07-31T00:00:00.000,Kings,NY,Passenger,1,0,1,64,65,1.538461538,994
2020-07-31T00:00:00.000,Kittitas,WA,Passenger,104,47,151,29762,29913,0.504797245,995
2020-07-31T00:00:00.000,Kittitas,WA,Truck,0,0,0,14561,14561,0,996
2020-07-31T00:00:00.000,Larimer,CO,Passenger,1,0,1,51,52,1.923076923,997
2020-07-31T00:00:00.000,Lincoln,WA,Passenger,5,11,16,7655,7671,0.20857776,998
2020-07-31T00:00:00.000,Montgomery,PA,Passenger,1,0,1,29,30,3.333333333,999
2020-10-31T00:00:00.000,Juneau,AK,Passenger,0,1,1,27,28,3.571428571,1000
